SYMBOL,Z,N,A,N/Z,M,delta,BEA
He,2,2,4,1.0,1,1.0,7.67752225
He,2,4,6,2.0,1,1.0,6.0247215
He,2,6,8,3.0,1,1.0,4.568840875
Li,3,2,5,0.6666666666666666,1,0.0,5.3293524
Li,3,3,6,1.0,0,-1.0,4.738885
Li,3,4,7,1.3333333333333333,0,0.0,5.830136857
Li,3,6,9,2.0,0,0.0,5.395980889
Li,3,8,11,2.6666666666666665,1,0.0,4.558429545
Be,4,2,6,0.5,1,1.0,5.577750167
Be,4,3,7,0.75,0,0.0,5.628717429
Be,4,4,8,1.0,0,1.0,6.9337555
Be,4,5,9,1.25,0,0.0,6.540728333
Be,4,6,10,1.5,0,1.0,6.998971
Be,4,8,12,2.0,1,1.0,6.345581583
B,5,2,7,0.4,1,0.0,3.969629
B,5,4,9,0.8,0,0.0,6.305563667
B,5,5,10,1.0,0,-1.0,6.3493222
B,5,6,11,1.2,0,0.0,7.067501182
B,5,7,12,1.4,0,-1.0,6.667959833
B,5,8,13,1.6,1,0.0,6.874324538
B,5,10,15,2.0,0,0.0,6.130025267
B,5,12,17,2.4,0,0.0,5.452818941
B,5,14,19,2.8,0,0.0,4.904347737
C,6,3,9,0.5,0,0.0,4.767737
C,6,4,10,0.6666666666666666,0,1.0,6.5569223
C,6,5,11,0.8333333333333334,0,0.0,6.858939455
C,6,6,12,1.0,0,1.0,7.717757083
C,6,7,13,1.1666666666666667,0,0.0,7.495828308
C,6,8,14,1.3333333333333333,1,1.0,7.806477214
C,6,9,15,1.5,0,0.0,7.307802667
C,6,10,16,1.6666666666666667,0,1.0,7.235681563
C,6,12,18,2.0,0,1.0,6.658483778
C,6,14,20,2.3333333333333335,0,1.0,6.1628174
C,6,16,22,2.6666666666666665,0,1.0,5.659635727
N,7,4,11,0.5714285714285714,0,0.0,5.672520182
N,7,6,13,0.8571428571428571,0,0.0,7.276341923
N,7,7,14,1.0,0,-1.0,7.2864415
N,7,8,15,1.1428571428571428,1,0.0,7.752416733
N,7,9,16,1.2857142857142858,0,-1.0,7.426637313
N,7,10,17,1.4285714285714286,0,0.0,7.476531647
N,7,11,18,1.5714285714285714,0,-1.0,7.149748278
N,7,12,19,1.7142857142857142,0,0.0,7.111811842
N,7,13,20,1.8571428571428572,0,-1.0,6.80845185
N,7,14,21,2.0,0,0.0,6.759728619
N,7,16,23,2.2857142857142856,0,0.0,6.351969739
O,8,4,12,0.5,1,1.0,5.50730625
O,8,5,13,0.625,1,0.0,6.252974923
O,8,6,14,0.75,1,1.0,7.380722429
O,8,7,15,0.875,1,0.0,7.5488368
O,8,8,16,1.0,1,1.0,8.114964313
O,8,9,17,1.125,1,0.0,7.909751059
O,8,10,18,1.25,1,1.0,8.040799556
O,8,11,19,1.375,1,0.0,7.800951526
O,8,12,20,1.5,1,1.0,7.8244315
O,8,13,21,1.625,1,0.0,7.576988333
O,8,14,22,1.75,1,1.0,7.567423136
O,8,15,23,1.875,1,0.0,7.284669261
O,8,16,24,2.0,1,1.0,7.220988167
O,8,18,26,2.25,1,1.0,6.742247038
F,9,6,15,0.6666666666666666,0,0.0,6.682811467
F,9,8,17,0.8888888888888888,1,0.0,7.702270882
F,9,9,18,1.0,0,-1.0,7.636634222
F,9,10,19,1.1111111111111112,0,0.0,7.870635
F,9,11,20,1.2222222222222223,0,-1.0,7.75128485
F,9,12,21,1.3333333333333333,0,0.0,7.867421905
F,9,13,22,1.4444444444444444,0,-1.0,7.693172318
F,9,14,23,1.5555555555555556,0,0.0,7.736981913
F,9,15,24,1.6666666666666667,0,-1.0,7.517640208
F,9,16,25,1.7777777777777777,0,0.0,7.50014436
F,9,17,26,1.8888888888888888,0,-1.0,7.215136346
F,9,18,27,2.0,0,0.0,7.109924296
F,9,20,29,2.2222222222222223,1,0.0,6.679806448
Ne,10,7,17,0.7,0,0.0,6.872188588
Ne,10,8,18,0.8,1,1.0,7.638151333
Ne,10,9,19,0.9,0,0.0,7.674620842
Ne,10,10,20,1.0,0,1.0,7.98151315
Ne,10,11,21,1.1,0,0.0,7.954895
Ne,10,12,22,1.2,0,1.0,8.140978364
Ne,10,13,23,1.3,0,0.0,8.017714783
Ne,10,14,24,1.4,0,1.0,8.096193792
Ne,10,15,25,1.5,0,0.0,7.92419272
Ne,10,16,26,1.6,0,1.0,7.939372038
Ne,10,17,27,1.7,0,0.0,7.694701407
Ne,10,18,28,1.8,0,1.0,7.617455821
Ne,10,19,29,1.9,0,0.0,7.356103069
Ne,10,20,30,2.0,1,1.0,7.245267433
Ne,10,24,34,2.4,0,1.0,6.417488235
Na,11,8,19,0.7272727272727273,1,0.0,7.199860316
Na,11,9,20,0.8181818181818182,0,-1.0,7.3577373
Na,11,10,21,0.9090909090909091,0,0.0,7.756780714
Na,11,11,22,1.0,0,-1.0,7.821222318
Na,11,12,23,1.0909090909090908,0,0.0,8.077243087
Na,11,13,24,1.1818181818181819,0,-1.0,8.02197
Na,11,14,25,1.2727272727272727,0,0.0,8.15120396
Na,11,15,26,1.3636363636363635,0,-1.0,8.035136269
Na,11,16,27,1.4545454545454546,0,0.0,8.091645481
Na,11,17,28,1.5454545454545454,0,-1.0,7.8965675
Na,11,18,29,1.6363636363636365,0,0.0,7.857832379
Na,11,19,30,1.7272727272727273,0,-1.0,7.638259167
Na,11,20,31,1.8181818181818181,1,0.0,7.560697452
Na,11,22,33,2.0,0,0.0,7.166398152
Na,11,24,35,2.1818181818181817,0,0.0,6.844855314
Na,11,26,37,2.3636363636363638,0,0.0,6.495071514
Mg,12,8,20,0.6666666666666666,1,1.0,7.03369895
Mg,12,9,21,0.75,0,0.0,7.285290619
Mg,12,10,22,0.8333333333333334,0,1.0,7.753969591
Mg,12,11,23,0.9166666666666666,0,0.0,7.889956565
Mg,12,12,24,1.0,0,1.0,8.19978675
Mg,12,13,25,1.0833333333333333,0,0.0,8.19307028
Mg,12,14,26,1.1666666666666667,0,1.0,8.356446154
Mg,12,15,27,1.25,0,0.0,8.28260063
Mg,12,16,28,1.3333333333333333,0,1.0,8.368751107
Mg,12,17,29,1.4166666666666667,0,0.0,8.214430345
Mg,12,18,30,1.5,0,1.0,8.206698067
Mg,12,19,31,1.5833333333333333,0,0.0,8.020430581
Mg,12,20,32,1.6666666666666667,1,1.0,7.968730219
Mg,12,21,33,1.75,0,0.0,7.735319788
Mg,12,22,34,1.8333333333333333,0,1.0,7.624566588
Mg,12,23,35,1.9166666666666667,0,0.0,7.433275171
Mg,12,24,36,2.0,0,1.0,7.348484083
Mg,12,26,38,2.1666666666666665,0,1.0,7.030795421
Mg,12,28,40,2.3333333333333335,1,1.0,6.694897525
Al,13,8,21,0.6153846153846154,1,0.0,6.60098
Al,13,10,23,0.7692307692307693,0,0.0,7.434567957
Al,13,11,24,0.8461538461538461,0,-1.0,7.638672458
Al,13,12,25,0.9230769230769231,0,0.0,7.997983
Al,13,13,26,1.0,0,-1.0,8.070520154
Al,13,14,27,1.0769230769230769,0,0.0,8.298844296
Al,13,15,28,1.1538461538461537,0,-1.0,8.277375643
Al,13,16,29,1.2307692307692308,0,0.0,8.40522769
Al,13,17,30,1.3076923076923077,0,-1.0,8.297061633
Al,13,18,31,1.3846153846153846,0,0.0,8.324731839
Al,13,19,32,1.4615384615384615,0,-1.0,8.179789813
Al,13,20,33,1.5384615384615385,1,0.0,8.160930818
Al,13,21,34,1.6153846153846154,0,-1.0,7.961523971
Al,13,22,35,1.6923076923076923,0,0.0,7.877854286
Al,13,23,36,1.7692307692307692,0,-1.0,7.703502833
Al,13,24,37,1.8461538461538463,0,0.0,7.630161216
Al,13,25,38,1.9230769230769231,0,-1.0,7.444040658
Al,13,26,39,2.0,0,0.0,7.353256641
Al,13,28,41,2.1538461538461537,1,0.0,7.062128122
Al,13,30,43,2.3076923076923075,0,0.0,6.762224674
Al,13,32,45,2.4615384615384617,0,0.0,6.468365867
Si,14,8,22,0.5714285714285714,1,1.0,6.409969682
Si,14,9,23,0.6428571428571429,0,0.0,6.779191087
Si,14,10,24,0.7142857142857143,0,1.0,7.326652125
Si,14,11,25,0.7857142857142857,0,0.0,7.58200064
Si,14,12,26,0.8571428571428571,0,1.0,7.976649577
Si,14,13,27,0.9285714285714286,0,0.0,8.112777259
Si,14,14,28,1.0,0,1.0,8.392527179
Si,14,15,29,1.0714285714285714,0,0.0,8.412203862
Si,14,16,30,1.1428571428571428,0,1.0,8.571986433
Si,14,17,31,1.2142857142857142,0,0.0,8.501995871
Si,14,18,32,1.2857142857142858,0,1.0,8.55826
Si,14,19,33,1.3571428571428572,0,0.0,8.44704403
Si,14,20,34,1.4285714285714286,1,1.0,8.454373088
Si,14,21,35,1.5,0,0.0,8.283088971
Si,14,22,36,1.5714285714285714,0,1.0,8.221333111
Si,14,23,37,1.6428571428571428,0,0.0,8.059249514
Si,14,24,38,1.7142857142857142,0,1.0,7.993220184
Si,14,25,39,1.7857142857142858,0,0.0,7.825507359
Si,14,26,40,1.8571428571428572,0,1.0,7.74864585
Si,14,27,41,1.9285714285714286,0,0.0,7.580967122
Si,14,28,42,2.0,1,1.0,7.498829786
Si,14,30,44,2.142857142857143,0,1.0,7.225517886
Si,14,32,46,2.2857142857142856,0,1.0,6.941626217
P,15,10,25,0.6666666666666666,0,0.0,6.97429256
P,15,12,27,0.8,0,0.0,7.715090444
P,15,13,28,0.8666666666666667,0,-1.0,7.902534714
P,15,14,29,0.9333333333333333,0,0.0,8.223039552
P,15,15,30,1.0,0,-1.0,8.2848889
P,15,16,31,1.0666666666666667,0,0.0,8.476503548
P,15,17,32,1.1333333333333333,0,-1.0,8.449861938
P,15,18,33,1.2,0,0.0,8.540467515
P,15,19,34,1.2666666666666666,0,-1.0,8.467669588
P,15,20,35,1.3333333333333333,1,0.0,8.507151257
P,15,21,36,1.4,0,-1.0,8.36895275
P,15,22,37,1.4666666666666666,0,0.0,8.334687405
P,15,23,38,1.5333333333333334,0,-1.0,8.199756526
P,15,24,39,1.6,0,0.0,8.155986256
P,15,25,40,1.6666666666666667,0,-1.0,8.01467605
P,15,26,41,1.7333333333333334,0,0.0,7.960838634
P,15,27,42,1.8,0,-1.0,7.80996669
P,15,28,43,1.8666666666666667,1,0.0,7.74233007
P,15,29,44,1.9333333333333333,0,-1.0,7.583268227
P,15,30,45,2.0,0,0.0,7.501423978
P,15,32,47,2.1333333333333333,0,0.0,7.240767
P,15,34,49,2.2666666666666666,0,0.0,6.966351612
S,16,10,26,0.625,0,1.0,6.817127846
S,16,11,27,0.6875,0,0.0,7.159634556
S,16,12,28,0.75,0,1.0,7.62088375
S,16,13,29,0.8125,0,0.0,7.847952897
S,16,14,30,0.875,0,1.0,8.199004533
S,16,15,31,0.9375,0,0.0,8.293029871
S,16,16,32,1.0,0,1.0,8.507751063
S,16,17,33,1.0625,0,0.0,8.516370758
S,16,18,34,1.125,0,1.0,8.634235706
S,16,19,35,1.1875,0,0.0,8.593076943
S,16,20,36,1.25,1,1.0,8.658657
S,16,21,37,1.3125,0,0.0,8.547925027
S,16,22,38,1.375,0,1.0,8.536121395
S,16,23,39,1.4375,0,0.0,8.423442795
S,16,24,40,1.5,0,1.0,8.397520875
S,16,25,41,1.5625,0,0.0,8.278509415
S,16,26,42,1.625,0,1.0,8.243948524
S,16,27,43,1.6875,0,0.0,8.107629
S,16,28,44,1.75,1,1.0,8.052446
S,16,29,45,1.8125,0,0.0,7.907898022
S,16,30,46,1.875,0,1.0,7.837692283
S,16,31,47,1.9375,0,0.0,7.682666319
S,16,32,48,2.0,0,1.0,7.594807333
S,16,34,50,2.125,0,1.0,7.3351134
Cl,17,12,29,0.7058823529411765,0,0.0,7.291125655
Cl,17,14,31,0.8235294117647058,0,0.0,7.949456097
Cl,17,15,32,0.8823529411764706,0,-1.0,8.085876094
Cl,17,16,33,0.9411764705882353,0,0.0,8.334945273
Cl,17,17,34,1.0,0,-1.0,8.3863025
Cl,17,18,35,1.0588235294117647,0,0.0,8.539879371
Cl,17,19,36,1.1176470588235294,0,-1.0,8.536286667
Cl,17,20,37,1.1764705882352942,1,0.0,8.634471811
Cl,17,21,38,1.2352941176470589,0,-1.0,8.556073474
Cl,17,22,39,1.2941176470588236,0,0.0,8.572491026
Cl,17,23,40,1.3529411764705883,0,-1.0,8.483355375
Cl,17,24,41,1.411764705882353,0,0.0,8.47743678
Cl,17,25,42,1.4705882352941178,0,-1.0,8.381034
Cl,17,26,43,1.5294117647058822,0,0.0,8.365691395
Cl,17,27,44,1.588235294117647,0,-1.0,8.253291295
Cl,17,28,45,1.6470588235294117,1,0.0,8.219026356
Cl,17,29,46,1.7058823529411764,0,-1.0,8.090744326
Cl,17,30,47,1.7647058823529411,0,0.0,8.033656596
Cl,17,31,48,1.8235294117647058,0,-1.0,7.894823875
Cl,17,32,49,1.8823529411764706,0,0.0,7.820397531
Cl,17,33,50,1.9411764705882353,0,-1.0,7.66965188
Cl,17,34,51,2.0,0,0.0,7.581069373
Cl,17,36,53,2.1176470588235294,0,0.0,7.320134849
Cl,17,38,55,2.235294117647059,0,0.0,7.066602073
Ar,18,13,31,0.7222222222222222,0,0.0,7.416925806
Ar,18,14,32,0.7777777777777778,0,1.0,7.830470469
Ar,18,15,33,0.8333333333333334,0,0.0,8.000403242
Ar,18,16,34,0.8888888888888888,0,1.0,8.275934441
Ar,18,17,35,0.9444444444444444,0,0.0,8.3628176
Ar,18,18,36,1.0,0,1.0,8.545685778
Ar,18,19,37,1.0555555555555556,0,0.0,8.573618243
Ar,18,20,38,1.1111111111111112,1,1.0,8.698946658
Ar,18,21,39,1.1666666666666667,0,0.0,8.647813077
Ar,18,22,40,1.2222222222222223,0,1.0,8.687841975
Ar,18,23,41,1.2777777777777777,0,0.0,8.619394146
Ar,18,24,42,1.3333333333333333,0,1.0,8.630928286
Ar,18,25,43,1.3888888888888888,0,0.0,8.55403514
Ar,18,26,44,1.4444444444444444,0,1.0,8.555106773
Ar,18,27,45,1.5,0,0.0,8.462150511
Ar,18,28,46,1.5555555555555556,1,1.0,8.444653109
Ar,18,29,47,1.6111111111111112,0,0.0,8.330076745
Ar,18,30,48,1.6666666666666667,0,1.0,8.283784521
Ar,18,31,49,1.7222222222222223,0,0.0,8.158409531
Ar,18,32,50,1.7777777777777777,0,1.0,8.09490008
Ar,18,33,51,1.8333333333333333,0,0.0,7.953838275
Ar,18,34,52,1.8888888888888888,0,1.0,7.873143231
Ar,18,36,54,2.0,0,1.0,7.632652537
Ar,18,38,56,2.111111111111111,0,1.0,7.398467875
Ar,18,40,58,2.2222222222222223,0,1.0,7.164127241
K,19,14,33,0.7368421052631579,0,0.0,7.546573636
K,19,16,35,0.8421052631578947,0,0.0,8.060500086
K,19,17,36,0.8947368421052632,0,-1.0,8.184236417
K,19,18,37,0.9473684210526315,0,0.0,8.399191297
K,19,19,38,1.0,0,-1.0,8.460868316
K,19,20,39,1.0526315789473684,1,0.0,8.61562
K,19,21,40,1.105263157894737,0,-1.0,8.594560875
K,19,22,41,1.1578947368421053,0,0.0,8.660314366
K,19,23,42,1.2105263157894737,0,-1.0,8.618182571
K,19,24,43,1.263157894736842,0,0.0,8.651734419
K,19,25,44,1.3157894736842106,0,-1.0,8.599359705
K,19,26,45,1.368421052631579,0,0.0,8.6209144
K,19,27,46,1.4210526315789473,0,-1.0,8.549151652
K,19,28,47,1.4736842105263157,1,0.0,8.550037511
K,19,29,48,1.5263157894736843,0,-1.0,8.450809458
K,19,30,49,1.5789473684210527,0,0.0,8.417652959
K,19,31,50,1.631578947368421,0,-1.0,8.30585418
K,19,32,51,1.6842105263157894,0,0.0,8.253741627
K,19,33,52,1.736842105263158,0,-1.0,8.125109615
K,19,34,53,1.7894736842105263,0,0.0,8.054995057
K,19,35,54,1.8421052631578947,0,-1.0,7.91926263
K,19,36,55,1.894736842105263,0,0.0,7.839737691
K,19,37,56,1.9473684210526316,0,-1.0,7.707104768
K,19,38,57,2.0,0,0.0,7.629461035
K,19,40,59,2.1052631578947367,0,0.0,7.41548122
K,19,42,61,2.210526315789474,0,0.0,7.178982377
Ca,20,14,34,0.7,1,1.0,7.385891529
Ca,20,15,35,0.75,1,0.0,7.623671457
Ca,20,16,36,0.8,1,1.0,7.956302222
Ca,20,17,37,0.85,1,0.0,8.111202351
Ca,20,18,38,0.9,1,1.0,8.353104868
Ca,20,19,39,0.95,1,0.0,8.443698205
Ca,20,20,40,1.0,1,1.0,8.6235025
Ca,20,21,41,1.05,1,0.0,8.628107073
Ca,20,22,42,1.1,1,1.0,8.715591524
Ca,20,23,43,1.15,1,0.0,8.696727558
Ca,20,24,44,1.2,1,1.0,8.749582773
Ca,20,25,45,1.25,1,0.0,8.7181716
Ca,20,26,46,1.3,1,1.0,8.756984522
Ca,20,27,47,1.35,1,0.0,8.703197851
Ca,20,28,48,1.4,1,1.0,8.719500688
Ca,20,29,49,1.45,1,0.0,8.633108939
Ca,20,30,50,1.5,1,1.0,8.6107651
Ca,20,31,51,1.55,1,0.0,8.51033949
Ca,20,32,52,1.6,1,1.0,8.467589327
Ca,20,33,53,1.65,1,0.0,8.349714057
Ca,20,34,54,1.7,1,1.0,8.288637352
Ca,20,35,55,1.75,1,0.0,8.164511673
Ca,20,36,56,1.8,1,1.0,8.095177018
Ca,20,37,57,1.85,1,0.0,7.97336414
Ca,20,38,58,1.9,1,1.0,7.905633672
Ca,20,39,59,1.95,1,0.0,7.780406051
Ca,20,40,60,2.0,1,1.0,7.7091502
Ca,20,42,62,2.1,1,1.0,7.48858471
Ca,20,44,64,2.2,1,1.0,7.263509734
Ca,20,46,66,2.3,1,1.0,7.048456273
Ca,20,48,68,2.4,1,1.0,6.841569765
Sc,21,16,37,0.7619047619047619,0,0.0,7.673688892
Sc,21,18,39,0.8571428571428571,0,0.0,8.129505179
Sc,21,19,40,0.9047619047619048,0,-1.0,8.25041535
Sc,21,20,41,0.9523809523809523,1,0.0,8.455939024
Sc,21,21,42,1.0,0,-1.0,8.48760181
Sc,21,22,43,1.0476190476190477,0,0.0,8.598200907
Sc,21,23,44,1.0952380952380953,0,-1.0,8.603963273
Sc,21,24,45,1.1428571428571428,0,0.0,8.677712178
Sc,21,25,46,1.1904761904761905,0,-1.0,8.668835087
Sc,21,26,47,1.2380952380952381,0,0.0,8.726668851
Sc,21,27,48,1.2857142857142858,0,-1.0,8.693005937
Sc,21,28,49,1.3333333333333333,1,0.0,8.726647367
Sc,21,29,50,1.380952380952381,0,-1.0,8.65617324
Sc,21,30,51,1.4285714285714286,0,0.0,8.647517412
Sc,21,31,52,1.4761904761904763,0,-1.0,8.561530115
Sc,21,32,53,1.5238095238095237,0,0.0,8.531187623
Sc,21,33,54,1.5714285714285714,0,-1.0,8.426891926
Sc,21,34,55,1.619047619047619,0,0.0,8.378006618
Sc,21,35,56,1.6666666666666667,0,-1.0,8.266840036
Sc,21,36,57,1.7142857142857142,0,0.0,8.209311772
Sc,21,37,58,1.7619047619047619,0,-1.0,8.099600828
Sc,21,38,59,1.8095238095238095,0,0.0,8.042585068
Sc,21,39,60,1.8571428571428572,0,-1.0,7.928854467
Sc,21,40,61,1.9047619047619047,0,0.0,7.867460213
Sc,21,41,62,1.9523809523809523,0,-1.0,7.741975903
Sc,21,42,63,2.0,0,0.0,7.666041079
Sc,21,44,65,2.0952380952380953,0,0.0,7.458732677
Sc,21,46,67,2.1904761904761907,0,0.0,7.259815582
Sc,21,48,69,2.2857142857142856,0,0.0,7.068429812
Sc,21,50,71,2.380952380952381,1,0.0,6.874092239
Ti,22,17,39,0.7727272727272727,0,0.0,7.708150615
Ti,22,18,40,0.8181818181818182,0,1.0,7.999276475
Ti,22,19,41,0.8636363636363636,0,0.0,8.146189415
Ti,22,20,42,0.9090909090909091,1,1.0,8.373542762
Ti,22,21,43,0.9545454545454546,0,0.0,8.428341698
Ti,22,22,44,1.0,0,1.0,8.558490932
Ti,22,23,45,1.0454545454545454,0,0.0,8.586180689
Ti,22,24,46,1.0909090909090908,0,1.0,8.678404
Ti,22,25,47,1.1363636363636365,0,0.0,8.688872872
Ti,22,26,48,1.1818181818181819,0,1.0,8.762818583
Ti,22,27,49,1.2272727272727273,0,0.0,8.746375204
Ti,22,28,50,1.2727272727272727,1,1.0,8.79467856
Ti,22,29,51,1.3181818181818181,0,0.0,8.737730843
Ti,22,30,52,1.3636363636363635,0,1.0,8.740549558
Ti,22,31,53,1.4090909090909092,0,0.0,8.667015264
Ti,22,32,54,1.4545454545454546,0,1.0,8.647243833
Ti,22,33,55,1.5,0,0.0,8.554912109
Ti,22,34,56,1.5454545454545454,0,1.0,8.516709875
Ti,22,35,57,1.5909090909090908,0,0.0,8.416837632
Ti,22,36,58,1.6363636363636365,0,1.0,8.369548138
Ti,22,37,59,1.6818181818181819,0,0.0,8.270414949
Ti,22,38,60,1.7272727272727273,0,1.0,8.222686767
Ti,22,39,61,1.7727272727272727,0,0.0,8.119042541
Ti,22,40,62,1.8181818181818181,0,1.0,8.0661975
Ti,22,41,63,1.8636363636363635,0,0.0,7.949870365
Ti,22,42,64,1.9090909090909092,0,1.0,7.881482953
Ti,22,43,65,1.9545454545454546,0,0.0,7.763516338
Ti,22,44,66,2.0,0,1.0,7.689718288
Ti,22,45,67,2.0454545454545454,0,0.0,7.576176045
Ti,22,46,68,2.090909090909091,0,1.0,7.504839485
Ti,22,48,70,2.1818181818181817,0,1.0,7.327034086
Ti,22,50,72,2.272727272727273,1,1.0,7.143049153
V,23,18,41,0.782608695652174,0,0.0,7.763075463
V,23,20,43,0.8695652173913043,1,0.0,8.18695786
V,23,21,44,0.9130434782608695,0,-1.0,8.266193409
V,23,22,45,0.9565217391304348,0,0.0,8.417178822
V,23,23,46,1.0,0,-1.0,8.478194022
V,23,24,47,1.0434782608695652,0,0.0,8.600379915
V,23,25,48,1.0869565217391304,0,-1.0,8.627973542
V,23,26,49,1.1304347826086956,0,0.0,8.716676551
V,23,27,50,1.173913043478261,0,-1.0,8.7131059
V,23,28,51,1.2173913043478262,1,0.0,8.771457941
V,23,29,52,1.2608695652173914,0,-1.0,8.730740904
V,23,30,53,1.3043478260869565,0,0.0,8.748065453
V,23,31,54,1.3478260869565217,0,-1.0,8.687370407
V,23,32,55,1.391304347826087,0,0.0,8.679378091
V,23,33,56,1.434782608695652,0,-1.0,8.600451786
V,23,34,57,1.4782608695652173,0,0.0,8.57387907
V,23,35,58,1.5217391304347827,0,-1.0,8.485881397
V,23,36,59,1.565217391304348,0,0.0,8.448962424
V,23,37,60,1.608695652173913,0,-1.0,8.362090867
V,23,38,61,1.6521739130434783,0,0.0,8.325095377
V,23,39,62,1.6956521739130435,0,-1.0,8.232840645
V,23,40,63,1.7391304347826086,0,0.0,8.189842905
V,23,41,64,1.7826086956521738,0,-1.0,8.083989141
V,23,42,65,1.826086956521739,0,0.0,8.024516262
V,23,43,66,1.8695652173913044,0,-1.0,7.918144985
V,23,44,67,1.9130434782608696,0,0.0,7.85437006
V,23,45,68,1.9565217391304348,0,-1.0,7.753445912
V,23,46,69,2.0,0,0.0,7.693302522
V,23,47,70,2.0434782608695654,0,-1.0,7.588602843
V,23,48,71,2.0869565217391304,0,0.0,7.523164225
V,23,50,73,2.1739130434782608,1,0.0,7.348470479
V,23,52,75,2.260869565217391,0,0.0,7.155996573
Cr,24,19,43,0.7916666666666666,0,0.0,7.804174837
Cr,24,20,44,0.8333333333333334,1,1.0,8.073686023
Cr,24,21,45,0.875,0,0.0,8.173860844
Cr,24,22,46,0.9166666666666666,0,1.0,8.342493739
Cr,24,23,47,0.9583333333333334,0,0.0,8.434261213
Cr,24,24,48,1.0,0,1.0,8.584083875
Cr,24,25,49,1.0416666666666667,0,0.0,8.626051837
Cr,24,26,50,1.0833333333333333,0,1.0,8.72696644
Cr,24,27,51,1.125,0,0.0,8.733364608
Cr,24,28,52,1.1666666666666667,1,1.0,8.799081731
Cr,24,29,53,1.2083333333333333,0,0.0,8.772474038
Cr,24,30,54,1.25,0,1.0,8.802325519
Cr,24,31,55,1.2916666666666667,0,0.0,8.7527496
Cr,24,32,56,1.3333333333333333,0,1.0,8.7549155
Cr,24,33,57,1.375,0,0.0,8.688025772
Cr,24,34,58,1.4166666666666667,0,1.0,8.671822224
Cr,24,35,59,1.4583333333333333,0,0.0,8.59424161
Cr,24,36,60,1.5,0,1.0,8.566334383
Cr,24,37,61,1.5416666666666667,0,0.0,8.490203557
Cr,24,38,62,1.5833333333333333,0,1.0,8.46251829
Cr,24,39,63,1.625,0,0.0,8.380266825
Cr,24,40,64,1.6666666666666667,0,1.0,8.345821688
Cr,24,41,65,1.7083333333333333,0,0.0,8.249166492
Cr,24,42,66,1.75,0,1.0,8.197419258
Cr,24,43,67,1.7916666666666667,0,0.0,8.101466149
Cr,24,44,68,1.8333333333333333,0,1.0,8.046618029
Cr,24,45,69,1.875,0,0.0,7.957229971
Cr,24,46,70,1.9166666666666667,0,1.0,7.907269343
Cr,24,47,71,1.9583333333333333,0,0.0,7.806209662
Cr,24,48,72,2.0,0,1.0,7.743174819
Cr,24,49,73,2.0416666666666665,0,0.0,7.641256904
Cr,24,50,74,2.0833333333333335,1,1.0,7.576560297
Cr,24,52,76,2.1666666666666665,0,1.0,7.389026487
Cr,24,54,78,2.25,0,1.0,7.203641038
Mn,25,20,45,0.8,1,0.0,7.878113956
Mn,25,21,46,0.84,0,-1.0,8.000139522
Mn,25,22,47,0.88,0,0.0,8.187616447
Mn,25,23,48,0.92,0,-1.0,8.296549833
Mn,25,24,49,0.96,0,0.0,8.460805224
Mn,25,25,50,1.0,0,-1.0,8.52241944
Mn,25,26,51,1.04,0,0.0,8.64061798
Mn,25,27,52,1.08,0,-1.0,8.665644442
Mn,25,28,53,1.12,1,0.0,8.748261491
Mn,25,29,54,1.16,0,-1.0,8.736927481
Mn,25,30,55,1.2,0,0.0,8.780341545
Mn,25,31,56,1.24,0,-1.0,8.744983964
Mn,25,32,57,1.28,0,0.0,8.759339825
Mn,25,33,58,1.32,0,-1.0,8.705892414
Mn,25,34,59,1.36,0,0.0,8.701363932
Mn,25,35,60,1.4,0,-1.0,8.63622305
Mn,25,36,61,1.44,0,0.0,8.619265115
Mn,25,37,62,1.48,0,-1.0,8.55420179
Mn,25,38,63,1.52,0,0.0,8.536165238
Mn,25,39,64,1.56,0,-1.0,8.464928234
Mn,25,40,65,1.6,0,0.0,8.4400558
Mn,25,41,66,1.64,0,-1.0,8.353612348
Mn,25,42,67,1.68,0,0.0,8.310670672
Mn,25,43,68,1.72,0,-1.0,8.222378029
Mn,25,44,69,1.76,0,0.0,8.174013681
Mn,25,45,70,1.8,0,-1.0,8.0926885
Mn,25,46,71,1.84,0,0.0,8.049556845
Mn,25,47,72,1.88,0,-1.0,7.956928319
Mn,25,48,73,1.92,0,0.0,7.901095274
Mn,25,49,74,1.96,0,-1.0,7.8080475
Mn,25,50,75,2.0,1,0.0,7.75159408
Mn,25,52,77,2.08,0,0.0,7.571341416
Mn,25,54,79,2.16,0,0.0,7.391989291
Mn,25,56,81,2.24,0,0.0,7.213174086
Fe,26,20,46,0.7692307692307693,1,1.0,7.75385813
Fe,26,21,47,0.8076923076923077,0,0.0,7.894640404
Fe,26,22,48,0.8461538461538461,0,1.0,8.098121583
Fe,26,23,49,0.8846153846153846,0,0.0,8.222498429
Fe,26,24,50,0.9230769230769231,0,1.0,8.39964232
Fe,26,25,51,0.9615384615384616,0,0.0,8.478239098
Fe,26,26,52,1.0,0,1.0,8.611251173
Fe,26,27,53,1.0384615384615385,0,0.0,8.651657057
Fe,26,28,54,1.0769230769230769,1,1.0,8.748109574
Fe,26,29,55,1.1153846153846154,0,0.0,8.750096673
Fe,26,30,56,1.1538461538461537,0,1.0,8.805251625
Fe,26,31,57,1.1923076923076923,0,0.0,8.782506
Fe,26,32,58,1.2307692307692308,0,1.0,8.807570741
Fe,26,33,59,1.2692307692307692,0,0.0,8.766201661
Fe,26,34,60,1.3076923076923077,0,1.0,8.772088667
Fe,26,35,61,1.3461538461538463,0,0.0,8.717843344
Fe,26,36,62,1.3846153846153846,0,1.0,8.710388468
Fe,26,37,63,1.4230769230769231,0,0.0,8.654984968
Fe,26,38,64,1.4615384615384615,0,1.0,8.64527775
Fe,26,39,65,1.5,0,0.0,8.583723769
Fe,26,40,66,1.5384615384615385,0,1.0,8.567176621
Fe,26,41,67,1.5769230769230769,0,0.0,8.489708239
Fe,26,42,68,1.6153846153846154,0,1.0,8.454413176
Fe,26,43,69,1.6538461538461537,0,0.0,8.372756551
Fe,26,44,70,1.6923076923076923,0,1.0,8.329914386
Fe,26,45,71,1.7307692307692308,0,0.0,8.255820451
Fe,26,46,72,1.7692307692307692,0,1.0,8.218743472
Fe,26,47,73,1.8076923076923077,0,0.0,8.133409699
Fe,26,48,74,1.8461538461538463,0,1.0,8.083705986
Fe,26,49,75,1.8846153846153846,0,0.0,7.99887932
Fe,26,50,76,1.9230769230769231,1,1.0,7.950053592
Fe,26,51,77,1.9615384615384615,0,0.0,7.847259481
Fe,26,52,78,2.0,0,1.0,7.775832859
Fe,26,54,80,2.076923076923077,0,1.0,7.601679675
Fe,26,56,82,2.1538461538461537,0,1.0,7.427770915
Fe,26,58,84,2.230769230769231,0,1.0,7.252834048
Co,27,22,49,0.8148148148148148,0,0.0,7.921153959
Co,27,24,51,0.8888888888888888,0,0.0,8.24327951
Co,27,25,52,0.9259259259259259,0,-1.0,8.340398808
Co,27,26,53,0.9629629629629629,0,0.0,8.488822585
Co,27,27,54,1.0,0,-1.0,8.550519315
Co,27,28,55,1.037037037037037,1,0.0,8.666243891
Co,27,29,56,1.0740740740740742,0,-1.0,8.680716875
Co,27,30,57,1.1111111111111112,0,0.0,8.746353088
Co,27,31,58,1.1481481481481481,0,-1.0,8.737274983
Co,27,32,59,1.1851851851851851,0,0.0,8.773745034
Co,27,33,60,1.2222222222222223,0,-1.0,8.74545765
Co,27,34,61,1.2592592592592593,0,0.0,8.762945459
Co,27,35,62,1.2962962962962963,0,-1.0,8.722493903
Co,27,36,63,1.3333333333333333,0,0.0,8.72722881
Co,27,37,64,1.3703703703703705,0,-1.0,8.683235484
Co,27,38,65,1.4074074074074074,0,0.0,8.683550723
Co,27,39,66,1.4444444444444444,0,-1.0,8.632781136
Co,27,40,67,1.4814814814814814,0,0.0,8.625804299
Co,27,41,68,1.5185185185185186,0,-1.0,8.558262912
Co,27,42,69,1.5555555555555556,0,0.0,8.531854551
Co,27,43,70,1.5925925925925926,0,-1.0,8.459162786
Co,27,44,71,1.6296296296296295,0,0.0,8.424171775
Co,27,45,72,1.6666666666666667,0,-1.0,8.355210069
Co,27,46,73,1.7037037037037037,0,0.0,8.322140151
Co,27,47,74,1.7407407407407407,0,-1.0,8.248305703
Co,27,48,75,1.7777777777777777,0,0.0,8.208749267
Co,27,49,76,1.8148148148148149,0,-1.0,8.131148303
Co,27,50,77,1.8518518518518519,1,0.0,8.088761896
Co,27,51,78,1.8888888888888888,0,-1.0,7.990476321
Co,27,52,79,1.9259259259259258,0,0.0,7.923012835
Co,27,53,80,1.962962962962963,0,-1.0,7.827286175
Co,27,54,81,2.0,0,0.0,7.756028593
Co,27,56,83,2.074074074074074,0,0.0,7.589362217
Co,27,58,85,2.1481481481481484,0,0.0,7.419115153
Ni,28,22,50,0.7857142857142857,1,1.0,7.81039032
Ni,28,23,51,0.8214285714285714,1,0.0,7.955241196
Ni,28,24,52,0.8571428571428571,1,1.0,8.148220846
Ni,28,25,53,0.8928571428571429,1,0.0,8.262204811
Ni,28,26,54,0.9285714285714286,1,1.0,8.424559056
Ni,28,27,55,0.9642857142857143,1,0.0,8.505723018
Ni,28,28,56,1.0,1,1.0,8.639033286
Ni,28,29,57,1.0357142857142858,1,0.0,8.664255877
Ni,28,30,58,1.0714285714285714,1,1.0,8.738766103
Ni,28,31,59,1.1071428571428572,1,0.0,8.741827695
Ni,28,32,60,1.1428571428571428,1,1.0,8.7883016
Ni,28,33,61,1.1785714285714286,1,0.0,8.771462197
Ni,28,34,62,1.2142857142857142,1,1.0,8.799017597
Ni,28,35,63,1.25,1,0.0,8.770913873
Ni,28,36,64,1.2857142857142858,1,1.0,8.786487969
Ni,28,37,65,1.3214285714285714,1,0.0,8.752939523
Ni,28,38,66,1.3571428571428572,1,1.0,8.762383242
Ni,28,39,67,1.3928571428571428,1,0.0,8.721222507
Ni,28,40,68,1.4285714285714286,1,1.0,8.722710735
Ni,28,41,69,1.4642857142857142,1,0.0,8.664046449
Ni,28,42,70,1.5,1,1.0,8.645534657
Ni,28,43,71,1.5357142857142858,1,0.0,8.580888521
Ni,28,44,72,1.5714285714285714,1,1.0,8.552885903
Ni,28,45,73,1.6071428571428572,1,0.0,8.488318192
Ni,28,46,74,1.6428571428571428,1,1.0,8.458567432
Ni,28,47,75,1.6785714285714286,1,0.0,8.395195467
Ni,28,48,76,1.7142857142857142,1,1.0,8.364812342
Ni,28,49,77,1.75,1,0.0,8.293687234
Ni,28,50,78,1.7857142857142858,1,1.0,8.257029692
Ni,28,51,79,1.8214285714285714,1,0.0,8.162491709
Ni,28,52,80,1.8571428571428572,1,1.0,8.098263038
Ni,28,53,81,1.8928571428571428,1,0.0,8.005828136
Ni,28,54,82,1.9285714285714286,1,1.0,7.937238549
Ni,28,55,83,1.9642857142857142,1,0.0,7.844637422
Ni,28,56,84,2.0,1,1.0,7.776531369
Ni,28,58,86,2.0714285714285716,1,1.0,7.609999279
Ni,28,60,88,2.142857142857143,1,1.0,7.439622341
Cu,29,24,53,0.8275862068965517,0,0.0,7.965050981
Cu,29,26,55,0.896551724137931,0,0.0,8.267973927
Cu,29,27,56,0.9310344827586207,0,-1.0,8.360496018
Cu,29,28,57,0.9655172413793104,1,0.0,8.503326158
Cu,29,29,58,1.0,0,-1.0,8.541898724
Cu,29,30,59,1.0344827586206897,0,0.0,8.627920746
Cu,29,31,60,1.0689655172413792,0,-1.0,8.6447377
Cu,29,32,61,1.103448275862069,0,0.0,8.703079607
Cu,29,33,62,1.1379310344827587,0,-1.0,8.699881565
Cu,29,34,63,1.1724137931034482,0,0.0,8.739491683
Cu,29,35,64,1.206896551724138,0,-1.0,8.722585156
Cu,29,36,65,1.2413793103448276,0,0.0,8.748220262
Cu,29,37,66,1.2758620689655173,0,-1.0,8.722534333
Cu,29,38,67,1.3103448275862069,0,0.0,8.738829776
Cu,29,39,68,1.3448275862068966,0,-1.0,8.707410265
Cu,29,40,69,1.3793103448275863,0,0.0,8.717534681
Cu,29,41,70,1.4137931034482758,0,-1.0,8.6681011
Cu,29,42,71,1.4482758620689655,0,0.0,8.65764393
Cu,29,43,72,1.4827586206896552,0,-1.0,8.604007819
Cu,29,44,73,1.5172413793103448,0,0.0,8.585861274
Cu,29,45,74,1.5517241379310345,0,-1.0,8.532108189
Cu,29,46,75,1.5862068965517242,0,0.0,8.51226696
Cu,29,47,76,1.6206896551724137,0,-1.0,8.453594737
Cu,29,48,77,1.6551724137931034,0,0.0,8.427359532
Cu,29,49,78,1.6896551724137931,0,-1.0,8.361157423
Cu,29,50,79,1.7241379310344827,1,0.0,8.328937342
Cu,29,51,80,1.7586206896551724,0,-1.0,8.242655775
Cu,29,52,81,1.793103448275862,0,0.0,8.187089395
Cu,29,53,82,1.8275862068965518,0,-1.0,8.100694756
Cu,29,54,83,1.8620689655172413,0,0.0,8.039190145
Cu,29,55,84,1.896551724137931,0,-1.0,7.950487167
Cu,29,56,85,1.9310344827586208,0,0.0,7.886919906
Cu,29,58,87,2.0,0,0.0,7.72828308
Cu,29,60,89,2.0689655172413794,0,0.0,7.566402461
Cu,29,62,91,2.1379310344827585,0,0.0,7.406500857
Cu,29,64,93,2.206896551724138,0,0.0,7.248183516
Zn,30,25,55,0.8333333333333334,0,0.0,7.980992145
Zn,30,26,56,0.8666666666666667,0,1.0,8.166535768
Zn,30,27,57,0.9,0,0.0,8.268473895
Zn,30,28,58,0.9333333333333333,1,1.0,8.419012138
Zn,30,29,59,0.9666666666666667,0,0.0,8.469310492
Zn,30,30,60,1.0,0,1.0,8.565335533
Zn,30,31,61,1.0333333333333334,0,0.0,8.595368033
Zn,30,32,62,1.0666666666666667,0,1.0,8.665116419
Zn,30,33,63,1.1,0,0.0,8.673463651
Zn,30,34,64,1.1333333333333333,0,1.0,8.723147469
Zn,30,35,65,1.1666666666666667,0,0.0,8.716404554
Zn,30,36,66,1.2,0,1.0,8.751132788
Zn,30,37,67,1.2333333333333334,0,0.0,8.732541224
Zn,30,38,68,1.2666666666666666,0,1.0,8.754972529
Zn,30,39,69,1.3,0,0.0,8.732337043
Zn,30,40,70,1.3333333333333333,0,1.0,8.750199386
Zn,30,41,71,1.3666666666666667,0,0.0,8.709132394
Zn,30,42,72,1.4,0,1.0,8.705922403
Zn,30,43,73,1.4333333333333333,0,0.0,8.662504055
Zn,30,44,74,1.4666666666666666,0,1.0,8.653473905
Zn,30,45,75,1.5,0,0.0,8.609789667
Zn,30,46,76,1.5333333333333334,0,1.0,8.599155618
Zn,30,47,77,1.5666666666666667,0,0.0,8.544300208
Zn,30,48,78,1.6,0,1.0,8.521366769
Zn,30,49,79,1.6333333333333333,0,0.0,8.459477253
Zn,30,50,80,1.6666666666666667,1,1.0,8.431111625
Zn,30,51,81,1.7,0,0.0,8.352232815
Zn,30,52,82,1.7333333333333334,0,1.0,8.304485951
Zn,30,53,83,1.7666666666666666,0,0.0,8.223579855
Zn,30,54,84,1.8,0,1.0,8.16859675
Zn,30,55,85,1.8333333333333333,0,0.0,8.083226482
Zn,30,56,86,1.8666666666666667,0,1.0,8.023630826
Zn,30,57,87,1.9,0,0.0,7.934691287
Zn,30,58,88,1.9333333333333333,0,1.0,7.871645375
Zn,30,60,90,2.0,0,1.0,7.717249844
Zn,30,62,92,2.066666666666667,0,1.0,7.56643212
Zn,30,64,94,2.1333333333333333,0,1.0,7.415432543
Zn,30,66,96,2.2,0,1.0,7.264445667
Zn,30,68,98,2.2666666666666666,0,1.0,7.119110378
Ga,31,26,57,0.8387096774193549,0,0.0,7.98924514
Ga,31,28,59,0.9032258064516129,1,0.0,8.26575778
Ga,31,29,60,0.9354838709677419,0,-1.0,8.3298241
Ga,31,30,61,0.967741935483871,0,0.0,8.439060279
Ga,31,31,62,1.0,0,-1.0,8.480516258
Ga,31,32,63,1.032258064516129,0,0.0,8.561417524
Ga,31,33,64,1.064516129032258,0,-1.0,8.583653625
Ga,31,34,65,1.096774193548387,0,0.0,8.646172662
Ga,31,35,66,1.1290322580645162,0,-1.0,8.649138409
Ga,31,36,67,1.1612903225806452,0,0.0,8.692268358
Ga,31,37,68,1.1935483870967742,0,-1.0,8.683343971
Ga,31,38,69,1.2258064516129032,0,0.0,8.713695319
Ga,31,39,70,1.2580645161290323,0,-1.0,8.698628243
Ga,31,40,71,1.2903225806451613,0,0.0,8.722800296
Ga,31,41,72,1.3225806451612903,0,-1.0,8.69097975
Ga,31,42,73,1.3548387096774193,0,0.0,8.696108493
Ga,31,43,74,1.3870967741935485,0,-1.0,8.663904676
Ga,31,44,75,1.4193548387096775,0,0.0,8.66539972
Ga,31,45,76,1.4516129032258065,0,-1.0,8.629938566
Ga,31,46,77,1.4838709677419355,0,0.0,8.627070805
Ga,31,47,78,1.5161290322580645,0,-1.0,8.579843333
Ga,31,48,79,1.5483870967741935,0,0.0,8.563977886
Ga,31,49,80,1.5806451612903225,0,-1.0,8.507382225
Ga,31,50,81,1.6129032258064515,1,0.0,8.482703309
Ga,31,51,82,1.6451612903225807,0,-1.0,8.41197689
Ga,31,52,83,1.6774193548387097,0,0.0,8.371073964
Ga,31,53,84,1.7096774193548387,0,-1.0,8.296484012
Ga,31,54,85,1.7419354838709677,0,0.0,8.247888576
Ga,31,55,86,1.7741935483870968,0,-1.0,8.168580349
Ga,31,56,87,1.8064516129032258,0,0.0,8.11524346
Ga,31,57,88,1.8387096774193548,0,-1.0,8.030962
Ga,31,58,89,1.8709677419354838,0,0.0,7.972713483
Ga,31,59,90,1.903225806451613,0,-1.0,7.888258644
Ga,31,60,91,1.935483870967742,0,0.0,7.829555319
Ga,31,61,92,1.967741935483871,0,-1.0,7.745743217
Ga,31,62,93,2.0,0,0.0,7.687678108
Ga,31,64,95,2.064516129032258,0,0.0,7.545716116
Ga,31,66,97,2.129032258064516,0,0.0,7.403063454
Ga,31,68,99,2.193548387096774,0,0.0,7.262310758
Ga,31,70,101,2.2580645161290325,0,0.0,7.122363723
Ga,31,72,103,2.3225806451612905,0,0.0,6.985911932
Ge,32,27,59,0.84375,0,0.0,7.986541458
Ge,32,28,60,0.875,1,1.0,8.157377017
Ge,32,29,61,0.90625,0,0.0,8.233475377
Ge,32,30,62,0.9375,0,1.0,8.35426071
Ge,32,31,63,0.96875,0,0.0,8.40693946
Ge,32,32,64,1.0,0,1.0,8.498807641
Ge,32,33,65,1.03125,0,0.0,8.533081785
Ge,32,34,66,1.0625,0,1.0,8.606673227
Ge,32,35,67,1.09375,0,0.0,8.618387866
Ge,32,36,68,1.125,0,1.0,8.669026426
Ge,32,37,69,1.15625,0,0.0,8.668722116
Ge,32,38,70,1.1875,0,1.0,8.706026243
Ge,32,39,71,1.21875,0,0.0,8.698026352
Ge,32,40,72,1.25,0,1.0,8.728055792
Ge,32,41,73,1.28125,0,0.0,8.704627082
Ge,32,42,74,1.3125,0,1.0,8.717287568
Ge,32,43,75,1.34375,0,0.0,8.69522636
Ge,32,44,76,1.375,0,1.0,8.706220987
Ge,32,45,77,1.40625,0,0.0,8.678293351
Ge,32,46,78,1.4375,0,1.0,8.682531679
Ge,32,47,79,1.46875,0,0.0,8.641957823
Ge,32,48,80,1.5,0,1.0,8.632224413
Ge,32,49,81,1.53125,0,0.0,8.580494259
Ge,32,50,82,1.5625,1,1.0,8.559123378
Ge,32,51,83,1.59375,0,0.0,8.495741
Ge,32,52,84,1.625,0,1.0,8.460924048
Ge,32,53,85,1.65625,0,0.0,8.392181965
Ge,32,54,86,1.6875,0,1.0,8.349515151
Ge,32,55,87,1.71875,0,0.0,8.275860805
Ge,32,56,88,1.75,0,1.0,8.228379318
Ge,32,57,89,1.78125,0,0.0,8.148262303
Ge,32,58,90,1.8125,0,1.0,8.094325422
Ge,32,59,91,1.84375,0,0.0,8.015041231
Ge,32,60,92,1.875,0,1.0,7.961320554
Ge,32,61,93,1.90625,0,0.0,7.881508484
Ge,32,62,94,1.9375,0,1.0,7.827073564
Ge,32,63,95,1.96875,0,0.0,7.747694884
Ge,32,64,96,2.0,0,1.0,7.69360276
Ge,32,66,98,2.0625,0,1.0,7.559602969
Ge,32,68,100,2.125,0,1.0,7.42275595
Ge,32,70,102,2.1875,0,1.0,7.286636333
Ge,32,72,104,2.25,0,1.0,7.154894317
Ge,32,74,106,2.3125,0,1.0,7.024773651
Ge,32,76,108,2.375,0,1.0,6.896207389
As,33,30,63,0.9090909090909091,0,0.0,8.210226444
As,33,31,64,0.9393939393939394,0,-1.0,8.276673
As,33,32,65,0.9696969696969697,0,0.0,8.380152723
As,33,33,66,1.0,0,-1.0,8.427040152
As,33,34,67,1.0303030303030303,0,0.0,8.511964701
As,33,35,68,1.0606060606060606,0,-1.0,8.533631353
As,33,36,69,1.0909090909090908,0,0.0,8.593113522
As,33,37,70,1.121212121212121,0,-1.0,8.602534157
As,33,38,71,1.1515151515151516,0,0.0,8.648326873
As,33,39,72,1.1818181818181819,0,-1.0,8.648036556
As,33,40,73,1.2121212121212122,0,0.0,8.684212192
As,33,41,74,1.2424242424242424,0,-1.0,8.669845905
As,33,42,75,1.2727272727272727,0,0.0,8.6900346
As,33,43,76,1.303030303030303,0,-1.0,8.676281592
As,33,44,77,1.3333333333333333,0,0.0,8.694497831
As,33,45,78,1.3636363636363635,0,-1.0,8.674809282
As,33,46,79,1.393939393939394,0,0.0,8.686191848
As,33,47,80,1.4242424242424243,0,-1.0,8.653872438
As,33,48,81,1.4545454545454546,0,0.0,8.651562901
As,33,49,82,1.4848484848484849,0,-1.0,8.606890024
As,33,50,83,1.5151515151515151,1,0.0,8.592417446
As,33,51,84,1.5454545454545454,0,-1.0,8.534360583
As,33,52,85,1.5757575757575757,0,0.0,8.504509906
As,33,53,86,1.606060606060606,0,-1.0,8.441861535
As,33,54,87,1.6363636363636365,0,0.0,8.40453354
As,33,55,88,1.6666666666666667,0,-1.0,8.336798545
As,33,56,89,1.696969696969697,0,0.0,8.294852236
As,33,57,90,1.7272727272727273,0,-1.0,8.221419067
As,33,58,91,1.7575757575757576,0,0.0,8.173987791
As,33,59,92,1.7878787878787878,0,-1.0,8.100389565
As,33,60,93,1.8181818181818181,0,0.0,8.052155172
As,33,61,94,1.8484848484848484,0,-1.0,7.976766234
As,33,62,95,1.878787878787879,0,0.0,7.926377979
As,33,63,96,1.9090909090909092,0,-1.0,7.851290146
As,33,64,97,1.9393939393939394,0,0.0,7.801088794
As,33,65,98,1.9696969696969697,0,-1.0,7.725700724
As,33,66,99,2.0,0,0.0,7.675262596
As,33,68,101,2.0606060606060606,0,0.0,7.54607496
As,33,70,103,2.121212121212121,0,0.0,7.414780388
As,33,72,105,2.1818181818181817,0,0.0,7.287015895
As,33,74,107,2.242424242424242,0,0.0,7.160695215
As,33,76,109,2.303030303030303,0,0.0,7.037442899
As,33,78,111,2.3636363636363638,0,0.0,6.91565691
Se,34,30,64,0.8823529411764706,0,1.0,8.109332813
Se,34,31,65,0.9117647058823529,0,0.0,8.188642554
Se,34,32,66,0.9411764705882353,0,1.0,8.302921955
Se,34,33,67,0.9705882352941176,0,0.0,8.36126697
Se,34,34,68,1.0,0,1.0,8.456440588
Se,34,35,69,1.0294117647058822,0,0.0,8.486994928
Se,34,36,70,1.0588235294117647,0,1.0,8.554318457
Se,34,37,71,1.088235294117647,0,0.0,8.572287423
Se,34,38,72,1.1176470588235294,0,1.0,8.625459153
Se,34,39,73,1.1470588235294117,0,0.0,8.632276329
Se,34,40,74,1.1764705882352942,0,1.0,8.674054649
Se,34,41,75,1.2058823529411764,0,0.0,8.66824952
Se,34,42,76,1.2352941176470589,0,1.0,8.69551875
Se,34,43,77,1.2647058823529411,0,0.0,8.688638013
Se,34,44,78,1.2941176470588236,0,1.0,8.712704603
Se,34,45,79,1.3235294117647058,0,0.0,8.700384595
Se,34,46,80,1.3529411764705883,0,1.0,8.718089975
Se,34,47,81,1.3823529411764706,0,0.0,8.69326021
Se,34,48,82,1.411764705882353,0,1.0,8.697648671
Se,34,49,83,1.4411764705882353,0,0.0,8.659602542
Se,34,50,84,1.4705882352941178,1,1.0,8.651611798
Se,34,51,85,1.5,0,0.0,8.598014282
Se,34,52,86,1.5294117647058822,0,1.0,8.572292209
Se,34,53,87,1.5588235294117647,0,0.0,8.515124
Se,34,54,88,1.588235294117647,0,1.0,8.482552409
Se,34,55,89,1.6176470588235294,0,0.0,8.420448865
Se,34,56,90,1.6470588235294117,0,1.0,8.383764811
Se,34,57,91,1.6764705882352942,0,0.0,8.316497154
Se,34,58,92,1.7058823529411764,0,1.0,8.275068283
Se,34,59,93,1.7352941176470589,0,0.0,8.206621226
Se,34,60,94,1.7647058823529411,0,1.0,8.163353926
Se,34,61,95,1.7941176470588236,0,0.0,8.092050463
Se,34,62,96,1.8235294117647058,0,1.0,8.045386073
Se,34,63,97,1.8529411764705883,0,0.0,7.974244175
Se,34,64,98,1.8823529411764706,0,1.0,7.927603888
Se,34,65,99,1.911764705882353,0,0.0,7.856127141
Se,34,66,100,1.9411764705882353,0,1.0,7.80924443
Se,34,67,101,1.9705882352941178,0,0.0,7.735946248
Se,34,68,102,2.0,0,1.0,7.687030588
Se,34,70,104,2.0588235294117645,0,1.0,7.559813779
Se,34,72,106,2.1176470588235294,0,1.0,7.435550028
Se,34,74,108,2.176470588235294,0,1.0,7.312823574
Se,34,76,110,2.235294117647059,0,1.0,7.193932655
Se,34,78,112,2.2941176470588234,0,1.0,7.078369098
Se,34,80,114,2.3529411764705883,0,1.0,6.957483228
Br,35,32,67,0.9142857142857143,0,0.0,8.163951896
Br,35,34,69,0.9714285714285714,0,0.0,8.336845928
Br,35,35,70,1.0,0,-1.0,8.378441814
Br,35,36,71,1.0285714285714285,0,0.0,8.455858056
Br,35,37,72,1.0571428571428572,0,-1.0,8.485263542
Br,35,38,73,1.0857142857142856,0,0.0,8.549082644
Br,35,39,74,1.1142857142857143,0,-1.0,8.56533827
Br,35,40,75,1.1428571428571428,0,0.0,8.616186707
Br,35,41,76,1.1714285714285715,0,-1.0,8.619149605
Br,35,42,77,1.2,0,0.0,8.654705273
Br,35,43,78,1.2285714285714286,0,-1.0,8.654136654
Br,35,44,79,1.2571428571428571,0,0.0,8.68352519
Br,35,45,80,1.2857142857142858,0,-1.0,8.678066288
Br,35,46,81,1.3142857142857143,0,0.0,8.701490519
Br,35,47,82,1.3428571428571427,0,-1.0,8.685109415
Br,35,48,83,1.3714285714285714,0,0.0,8.696669446
Br,35,49,84,1.4,0,-1.0,8.667810417
Br,35,50,85,1.4285714285714286,1,0.0,8.669037718
Br,35,51,86,1.457142857142857,0,-1.0,8.619095372
Br,35,52,87,1.4857142857142858,0,0.0,8.597246368
Br,35,53,88,1.5142857142857142,0,-1.0,8.544210205
Br,35,54,89,1.542857142857143,0,0.0,8.515016775
Br,35,55,90,1.5714285714285714,0,-1.0,8.456718367
Br,35,56,91,1.6,0,0.0,8.423310758
Br,35,57,92,1.6285714285714286,0,-1.0,8.362594283
Br,35,58,93,1.6571428571428573,0,0.0,8.327194086
Br,35,59,94,1.6857142857142857,0,-1.0,8.264489202
Br,35,60,95,1.7142857142857142,0,0.0,8.226651726
Br,35,61,96,1.7428571428571429,0,-1.0,8.160019031
Br,35,62,97,1.7714285714285714,0,0.0,8.117766258
Br,35,63,98,1.8,0,-1.0,8.05130101
Br,35,64,99,1.8285714285714285,0,0.0,8.008709697
Br,35,65,100,1.8571428571428572,0,-1.0,7.94194618
Br,35,66,101,1.8857142857142857,0,0.0,7.898734871
Br,35,67,102,1.9142857142857144,0,-1.0,7.830278186
Br,35,68,103,1.9428571428571428,0,0.0,7.785130981
Br,35,69,104,1.9714285714285715,0,-1.0,7.714176288
Br,35,70,105,2.0,0,0.0,7.665812619
Br,35,71,106,2.0285714285714285,0,-1.0,7.595065981
Br,35,72,107,2.057142857142857,0,0.0,7.545677224
Br,35,73,108,2.085714285714286,0,-1.0,7.476881694
Br,35,74,109,2.1142857142857143,0,0.0,7.429123752
Br,35,75,110,2.142857142857143,0,-1.0,7.362131745
Br,35,76,111,2.1714285714285713,0,0.0,7.316383955
Br,35,77,112,2.2,0,-1.0,7.251667625
Br,35,78,113,2.2285714285714286,0,0.0,7.207457655
Br,35,80,115,2.2857142857142856,0,0.0,7.095474296
Br,35,82,117,2.342857142857143,1,0.0,6.982185402
Kr,36,32,68,0.8888888888888888,0,1.0,8.065668721
Kr,36,33,69,0.9166666666666666,0,0.0,8.143346986
Kr,36,34,70,0.9444444444444444,0,1.0,8.256001786
Kr,36,35,71,0.9722222222222222,0,0.0,8.307705113
Kr,36,36,72,1.0,0,1.0,8.394332264
Kr,36,37,73,1.0277777777777777,0,0.0,8.434163123
Kr,36,38,74,1.0555555555555556,0,1.0,8.507667081
Kr,36,39,75,1.0833333333333333,0,0.0,8.532764053
Kr,36,40,76,1.1111111111111112,0,1.0,8.592110921
Kr,36,41,77,1.1388888888888888,0,0.0,8.603339429
Kr,36,42,78,1.1666666666666667,0,1.0,8.646704321
Kr,36,43,79,1.1944444444444444,0,0.0,8.651263671
Kr,36,44,80,1.2222222222222223,0,1.0,8.6848444
Kr,36,45,81,1.25,0,0.0,8.685318222
Kr,36,46,82,1.2777777777777777,0,1.0,8.713583463
Kr,36,47,83,1.3055555555555556,0,0.0,8.704952759
Kr,36,48,84,1.3333333333333333,0,1.0,8.723033143
Kr,36,49,85,1.3611111111111112,0,0.0,8.702976165
Kr,36,50,86,1.3888888888888888,1,1.0,8.713044663
Kr,36,51,87,1.4166666666666667,0,0.0,8.665811989
Kr,36,52,88,1.4444444444444444,0,1.0,8.646907068
Kr,36,53,89,1.4722222222222223,0,0.0,8.597303978
Kr,36,54,90,1.5,0,1.0,8.570822033
Kr,36,55,91,1.5277777777777777,0,0.0,8.515947
Kr,36,56,92,1.5555555555555556,0,1.0,8.485453891
Kr,36,57,93,1.5833333333333333,0,0.0,8.43050428
Kr,36,58,94,1.6111111111111112,0,1.0,8.400376234
Kr,36,59,95,1.6388888888888888,0,0.0,8.343074421
Kr,36,60,96,1.6666666666666667,0,1.0,8.31034125
Kr,36,61,97,1.6944444444444444,0,0.0,8.24798933
Kr,36,62,98,1.7222222222222223,0,1.0,8.209771439
Kr,36,63,99,1.75,0,0.0,8.147778525
Kr,36,64,100,1.7777777777777777,0,1.0,8.10904851
Kr,36,65,101,1.8055555555555556,0,0.0,8.046596129
Kr,36,66,102,1.8333333333333333,0,1.0,8.006682431
Kr,36,67,103,1.8611111111111112,0,0.0,7.942651961
Kr,36,68,104,1.8888888888888888,0,1.0,7.900886519
Kr,36,69,105,1.9166666666666667,0,0.0,7.834034943
Kr,36,70,106,1.9444444444444444,0,1.0,7.788686783
Kr,36,71,107,1.9722222222222223,0,0.0,7.72021686
Kr,36,72,108,2.0,0,1.0,7.672100981
Kr,36,73,109,2.0277777777777777,0,0.0,7.60662811
Kr,36,74,110,2.0555555555555554,0,1.0,7.561710936
Kr,36,75,111,2.0833333333333335,0,0.0,7.497461685
Kr,36,76,112,2.111111111111111,0,1.0,7.45425758
Kr,36,77,113,2.138888888888889,0,0.0,7.392796345
Kr,36,78,114,2.1666666666666665,0,1.0,7.351358614
Kr,36,79,115,2.1944444444444446,0,0.0,7.290224252
Kr,36,80,116,2.2222222222222223,0,1.0,7.24807144
Kr,36,82,118,2.2777777777777777,1,1.0,7.141693
Rb,37,34,71,0.918918918918919,0,0.0,8.125525746
Rb,37,36,73,0.972972972972973,0,0.0,8.285686425
Rb,37,37,74,1.0,0,-1.0,8.336280378
Rb,37,38,75,1.027027027027027,0,0.0,8.42000256
Rb,37,39,76,1.054054054054054,0,-1.0,8.455093395
Rb,37,40,77,1.0810810810810811,0,0.0,8.523784688
Rb,37,41,78,1.1081081081081081,0,-1.0,8.543286474
Rb,37,42,79,1.135135135135135,0,0.0,8.594140063
Rb,37,43,80,1.162162162162162,0,-1.0,8.605119025
Rb,37,44,81,1.1891891891891893,0,0.0,8.644447148
Rb,37,45,82,1.2162162162162162,0,-1.0,8.650835146
Rb,37,46,83,1.2432432432432432,0,0.0,8.684408855
Rb,37,47,84,1.2702702702702702,0,-1.0,8.684221762
Rb,37,48,85,1.2972972972972974,0,0.0,8.710089753
Rb,37,49,86,1.3243243243243243,0,-1.0,8.698000233
Rb,37,50,87,1.3513513513513513,1,0.0,8.715490678
Rb,37,51,88,1.3783783783783783,0,-1.0,8.672389307
Rb,37,52,89,1.4054054054054055,0,0.0,8.656927978
Rb,37,53,90,1.4324324324324325,0,-1.0,8.612185356
Rb,37,54,91,1.4594594594594594,0,0.0,8.589720956
Rb,37,55,92,1.4864864864864864,0,-1.0,8.539693174
Rb,37,56,93,1.5135135135135136,0,0.0,8.513468871
Rb,37,57,94,1.5405405405405406,0,-1.0,8.462443043
Rb,37,58,95,1.5675675675675675,0,0.0,8.435959421
Rb,37,59,96,1.5945945945945945,0,-1.0,8.385013135
Rb,37,60,97,1.6216216216216217,0,0.0,8.358296804
Rb,37,61,98,1.6486486486486487,0,-1.0,8.302869908
Rb,37,62,99,1.6756756756756757,0,0.0,8.270915899
Rb,37,63,100,1.7027027027027026,0,-1.0,8.2135399
Rb,37,64,101,1.7297297297297298,0,0.0,8.178782604
Rb,37,65,102,1.7567567567567568,0,-1.0,8.12015648
Rb,37,66,103,1.7837837837837838,0,0.0,8.083494592
Rb,37,67,104,1.8108108108108107,0,-1.0,8.023014327
Rb,37,68,105,1.837837837837838,0,0.0,7.984194829
Rb,37,69,106,1.864864864864865,0,-1.0,7.920936736
Rb,37,70,107,1.8918918918918919,0,0.0,7.878588318
Rb,37,71,108,1.9189189189189189,0,-1.0,7.813693759
Rb,37,72,109,1.945945945945946,0,0.0,7.768741743
Rb,37,73,110,1.972972972972973,0,-1.0,7.706590264
Rb,37,74,111,2.0,0,0.0,7.664680405
Rb,37,75,112,2.027027027027027,0,-1.0,7.603886402
Rb,37,76,113,2.054054054054054,0,0.0,7.563790558
Rb,37,77,114,2.081081081081081,0,-1.0,7.505392754
Rb,37,78,115,2.108108108108108,0,0.0,7.466695252
Rb,37,79,116,2.135135135135135,0,-1.0,7.409306216
Rb,37,80,117,2.1621621621621623,0,0.0,7.370507718
Rb,37,81,118,2.189189189189189,0,-1.0,7.309995195
Rb,37,82,119,2.2162162162162162,1,0.0,7.269150731
Sr,38,34,72,0.8947368421052632,0,1.0,8.031837486
Sr,38,35,73,0.9210526315789473,0,0.0,8.105751041
Sr,38,36,74,0.9473684210526315,0,1.0,8.212617311
Sr,38,37,75,0.9736842105263158,0,0.0,8.273488067
Sr,38,38,76,1.0,0,1.0,8.366969303
Sr,38,39,77,1.0263157894736843,0,0.0,8.41152161
Sr,38,40,78,1.0526315789473684,0,1.0,8.489055205
Sr,38,41,79,1.0789473684210527,0,0.0,8.516007861
Sr,38,42,80,1.105263157894737,0,1.0,8.5735679
Sr,38,43,81,1.131578947368421,0,0.0,8.590199346
Sr,38,44,82,1.1578947368421053,0,1.0,8.634542854
Sr,38,45,83,1.1842105263157894,0,0.0,8.646000976
Sr,38,46,84,1.2105263157894737,0,1.0,8.684073607
Sr,38,47,85,1.236842105263158,0,0.0,8.691643094
Sr,38,48,86,1.263157894736842,0,1.0,8.72464293
Sr,38,49,87,1.2894736842105263,0,0.0,8.720032816
Sr,38,50,88,1.3157894736842106,1,1.0,8.744480648
Sr,38,51,89,1.3421052631578947,0,0.0,8.704737157
Sr,38,52,90,1.368421052631579,0,1.0,8.691978478
Sr,38,53,91,1.394736842105263,0,0.0,8.651273769
Sr,38,54,92,1.4210526315789473,0,1.0,8.632040554
Sr,38,55,93,1.4473684210526316,0,0.0,8.586043301
Sr,38,56,94,1.4736842105263157,0,1.0,8.563300777
Sr,38,57,95,1.5,0,0.0,8.515202926
Sr,38,58,96,1.5263157894736843,0,1.0,8.49139449
Sr,38,59,97,1.5526315789473684,0,0.0,8.447074598
Sr,38,60,98,1.5789473684210527,0,1.0,8.426647347
Sr,38,61,99,1.605263157894737,0,0.0,8.377739404
Sr,38,62,100,1.631578947368421,0,1.0,8.35166454
Sr,38,63,101,1.6578947368421053,0,0.0,8.298694337
Sr,38,64,102,1.6842105263157894,0,1.0,8.267715431
Sr,38,65,103,1.7105263157894737,0,0.0,8.212487359
Sr,38,66,104,1.736842105263158,0,1.0,8.178668365
Sr,38,67,105,1.763157894736842,0,0.0,8.121313857
Sr,38,68,106,1.7894736842105263,0,1.0,8.085035245
Sr,38,69,107,1.8157894736842106,0,0.0,8.025000822
Sr,38,70,108,1.8421052631578947,0,1.0,7.985300185
Sr,38,71,109,1.868421052631579,0,0.0,7.923667284
Sr,38,72,110,1.894736842105263,0,1.0,7.881578618
Sr,38,73,111,1.9210526315789473,0,0.0,7.82255382
Sr,38,74,112,1.9473684210526316,0,1.0,7.783465643
Sr,38,75,113,1.9736842105263157,0,0.0,7.726038106
Sr,38,76,114,2.0,0,1.0,7.688969404
Sr,38,77,115,2.026315789473684,0,0.0,7.633292026
Sr,38,78,116,2.0526315789473686,0,1.0,7.597003224
Sr,38,79,117,2.0789473684210527,0,0.0,7.543207359
Sr,38,80,118,2.1052631578947367,0,1.0,7.507620254
Sr,38,81,119,2.1315789473684212,0,0.0,7.449426933
Sr,38,82,120,2.1578947368421053,1,1.0,7.410694008
Y,39,36,75,0.9230769230769231,0,0.0,8.0905508
Y,39,38,77,0.9743589743589743,0,0.0,8.264741688
Y,39,39,78,1.0,0,-1.0,8.319345346
Y,39,40,79,1.0256410256410255,0,0.0,8.406168051
Y,39,41,80,1.0512820512820513,0,-1.0,8.440781438
Y,39,42,81,1.0769230769230769,0,0.0,8.505253012
Y,39,43,82,1.1025641025641026,0,-1.0,8.529185183
Y,39,44,83,1.1282051282051282,0,0.0,8.580225735
Y,39,45,84,1.1538461538461537,0,-1.0,8.59849731
Y,39,46,85,1.1794871794871795,0,0.0,8.6428846
Y,39,47,86,1.205128205128205,0,-1.0,8.656781756
Y,39,48,87,1.2307692307692308,0,0.0,8.69555454
Y,39,49,88,1.2564102564102564,0,-1.0,8.697155284
Y,39,50,89,1.2820512820512822,1,0.0,8.727355112
Y,39,51,90,1.3076923076923077,0,-1.0,8.693231922
Y,39,52,91,1.3333333333333333,0,0.0,8.685872484
Y,39,53,92,1.358974358974359,0,-1.0,8.649891522
Y,39,54,93,1.3846153846153846,0,0.0,8.635270753
Y,39,55,94,1.4102564102564104,0,-1.0,8.593873149
Y,39,56,95,1.435897435897436,0,0.0,8.575872726
Y,39,57,96,1.4615384615384615,0,-1.0,8.532103656
Y,39,58,97,1.4871794871794872,0,0.0,8.512643649
Y,39,59,98,1.5128205128205128,0,-1.0,8.470418357
Y,39,60,99,1.5384615384615385,0,0.0,8.45177998
Y,39,61,100,1.564102564102564,0,-1.0,8.40755062
Y,39,62,101,1.5897435897435896,0,0.0,8.385757772
Y,39,63,102,1.6153846153846154,0,-1.0,8.337336373
Y,39,64,103,1.641025641025641,0,0.0,8.310496932
Y,39,65,104,1.6666666666666667,0,-1.0,8.259649288
Y,39,66,105,1.6923076923076923,0,0.0,8.22979359
Y,39,67,106,1.7179487179487178,0,-1.0,8.176619698
Y,39,68,107,1.7435897435897436,0,0.0,8.144113346
Y,39,69,108,1.7692307692307692,0,-1.0,8.087949417
Y,39,70,109,1.794871794871795,0,0.0,8.051755798
Y,39,71,110,1.8205128205128205,0,-1.0,7.9948828
Y,39,72,111,1.8461538461538463,0,0.0,7.957641937
Y,39,73,112,1.8717948717948718,0,-1.0,7.902465607
Y,39,74,113,1.8974358974358974,0,0.0,7.867532947
Y,39,75,114,1.9230769230769231,0,-1.0,7.813330219
Y,39,76,115,1.9487179487179487,0,0.0,7.779358661
Y,39,77,116,1.9743589743589745,0,-1.0,7.726659379
Y,39,78,117,2.0,0,0.0,7.693007932
Y,39,79,118,2.0256410256410255,0,-1.0,7.642017983
Y,39,80,119,2.051282051282051,0,0.0,7.60894321
Y,39,81,120,2.076923076923077,0,-1.0,7.553355417
Y,39,82,121,2.1025641025641026,1,0.0,7.517076645
Zr,40,36,76,0.9,0,1.0,8.004604592
Zr,40,37,77,0.925,0,0.0,8.08497061
Zr,40,38,78,0.95,0,1.0,8.197276295
Zr,40,39,79,0.975,0,0.0,8.260995241
Zr,40,40,80,1.0,0,1.0,8.356213413
Zr,40,41,81,1.025,0,0.0,8.397643148
Zr,40,42,82,1.05,0,1.0,8.468220732
Zr,40,43,83,1.075,0,0.0,8.498809566
Zr,40,44,84,1.1,0,1.0,8.555932798
Zr,40,45,85,1.125,0,0.0,8.580251824
Zr,40,46,86,1.15,0,1.0,8.630217151
Zr,40,47,87,1.175,0,0.0,8.649715724
Zr,40,48,88,1.2,0,1.0,8.693564318
Zr,40,49,89,1.225,0,0.0,8.700721888
Zr,40,50,90,1.25,1,1.0,8.736044389
Zr,40,51,91,1.275,0,0.0,8.707012736
Zr,40,52,92,1.3,0,1.0,8.704540087
Zr,40,53,93,1.325,0,0.0,8.672676172
Zr,40,54,94,1.35,0,1.0,8.662076404
Zr,40,55,95,1.375,0,0.0,8.624595611
Zr,40,56,96,1.4,0,1.0,8.610665688
Zr,40,57,97,1.425,0,0.0,8.570255845
Zr,40,58,98,1.45,0,1.0,8.554194102
Zr,40,59,99,1.475,0,0.0,8.513737091
Zr,40,60,100,1.5,0,1.0,8.49657392
Zr,40,61,101,1.525,0,0.0,8.456732881
Zr,40,62,102,1.55,0,1.0,8.438945265
Zr,40,63,103,1.575,0,0.0,8.394760427
Zr,40,64,104,1.6,0,1.0,8.371762058
Zr,40,65,105,1.625,0,0.0,8.32496761
Zr,40,66,106,1.65,0,1.0,8.298762038
Zr,40,67,107,1.675,0,0.0,8.249442047
Zr,40,68,108,1.7,0,1.0,8.220394833
Zr,40,69,109,1.725,0,0.0,8.167898734
Zr,40,70,110,1.75,0,1.0,8.135019755
Zr,40,71,111,1.775,0,0.0,8.082642486
Zr,40,72,112,1.8,0,1.0,8.049988402
Zr,40,73,113,1.825,0,0.0,7.998617965
Zr,40,74,114,1.85,0,1.0,7.967793632
Zr,40,75,115,1.875,0,0.0,7.916568374
Zr,40,76,116,1.9,0,1.0,7.885453112
Zr,40,77,117,1.925,0,0.0,7.83535888
Zr,40,78,118,1.95,0,1.0,7.803983839
Zr,40,79,119,1.975,0,0.0,7.755522992
Zr,40,80,120,2.0,0,1.0,7.724693217
Zr,40,81,121,2.025,0,0.0,7.671452645
Zr,40,82,122,2.05,1,1.0,7.637376434
Zr,40,84,124,2.1,0,1.0,7.514742185
Nb,41,38,79,0.926829268292683,0,0.0,8.079737253
Nb,41,40,81,0.975609756097561,0,0.0,8.253432975
Nb,41,41,82,1.0,0,-1.0,8.302406256
Nb,41,42,83,1.024390243902439,0,0.0,8.379921012
Nb,41,43,84,1.048780487804878,0,-1.0,8.417643167
Nb,41,44,85,1.0731707317073171,0,0.0,8.481298918
Nb,41,45,86,1.0975609756097562,0,-1.0,8.512505581
Nb,41,46,87,1.1219512195121952,0,0.0,8.568722126
Nb,41,47,88,1.146341463414634,0,-1.0,8.594819591
Nb,41,48,89,1.170731707317073,0,0.0,8.644748056
Nb,41,49,90,1.1951219512195121,0,-1.0,8.657951822
Nb,41,50,91,1.2195121951219512,1,0.0,8.698906275
Nb,41,51,92,1.2439024390243902,0,-1.0,8.675318196
Nb,41,52,93,1.2682926829268293,0,0.0,8.677991473
Nb,41,53,94,1.2926829268292683,0,-1.0,8.65115034
Nb,41,54,95,1.3170731707317074,0,0.0,8.645348632
Nb,41,55,96,1.3414634146341464,0,-1.0,8.612713448
Nb,41,56,97,1.3658536585365855,0,0.0,8.60332833
Nb,41,57,98,1.3902439024390243,0,-1.0,8.568648714
Nb,41,58,99,1.4146341463414633,0,0.0,8.557906939
Nb,41,59,100,1.4390243902439024,0,-1.0,8.52271266
Nb,41,60,101,1.4634146341463414,0,0.0,8.510616307
Nb,41,61,102,1.4878048780487805,0,-1.0,8.473694647
Nb,41,62,103,1.5121951219512195,0,0.0,8.459058767
Nb,41,63,104,1.5365853658536586,0,-1.0,8.419153462
Nb,41,64,105,1.5609756097560976,0,0.0,8.400879819
Nb,41,65,106,1.5853658536585367,0,-1.0,8.358695802
Nb,41,66,107,1.6097560975609757,0,0.0,8.337632776
Nb,41,67,108,1.6341463414634145,0,-1.0,8.292413111
Nb,41,68,109,1.6585365853658536,0,0.0,8.267892037
Nb,41,69,110,1.6829268292682926,0,-1.0,8.219026382
Nb,41,70,111,1.7073170731707317,0,0.0,8.190110694
Nb,41,71,112,1.7317073170731707,0,-1.0,8.140641
Nb,41,72,113,1.7560975609756098,0,0.0,8.110759186
Nb,41,73,114,1.7804878048780488,0,-1.0,8.061864228
Nb,41,74,115,1.8048780487804879,0,0.0,8.032671957
Nb,41,75,116,1.829268292682927,0,-1.0,7.984937672
Nb,41,76,117,1.853658536585366,0,0.0,7.956636256
Nb,41,77,118,1.8780487804878048,0,-1.0,7.909782763
Nb,41,78,119,1.9024390243902438,0,0.0,7.88141605
Nb,41,79,120,1.9268292682926829,0,-1.0,7.835872308
Nb,41,80,121,1.951219512195122,0,0.0,7.807669149
Nb,41,81,122,1.975609756097561,0,-1.0,7.757326139
Nb,41,82,123,2.0,1,0.0,7.72596539
Nb,41,84,125,2.048780487804878,0,0.0,7.60714432
Mo,42,38,80,0.9047619047619048,0,1.0,7.994486188
Mo,42,39,81,0.9285714285714286,0,0.0,8.072780901
Mo,42,40,82,0.9523809523809523,0,1.0,8.181288646
Mo,42,41,83,0.9761904761904762,0,0.0,8.23699588
Mo,42,42,84,1.0,0,1.0,8.32067194
Mo,42,43,85,1.0238095238095237,0,0.0,8.364922612
Mo,42,44,86,1.0476190476190477,0,1.0,8.434534093
Mo,42,45,87,1.0714285714285714,0,0.0,8.471895529
Mo,42,46,88,1.0952380952380953,0,1.0,8.5336615
Mo,42,47,89,1.119047619047619,0,0.0,8.565667067
Mo,42,48,90,1.1428571428571428,0,1.0,8.6210115
Mo,42,49,91,1.1666666666666667,0,0.0,8.639638022
Mo,42,50,92,1.1904761904761905,1,1.0,8.685623533
Mo,42,51,93,1.2142857142857142,0,0.0,8.666955699
Mo,42,52,94,1.2380952380952381,0,1.0,8.674269064
Mo,42,53,95,1.2619047619047619,0,0.0,8.651971021
Mo,42,54,96,1.2857142857142858,0,1.0,8.650502333
Mo,42,55,97,1.3095238095238095,0,0.0,8.622215845
Mo,42,56,98,1.3333333333333333,0,1.0,8.616894929
Mo,42,57,99,1.3571428571428572,0,0.0,8.58744802
Mo,42,58,100,1.380952380952381,0,1.0,8.58154689
Mo,42,59,101,1.4047619047619047,0,0.0,8.550669792
Mo,42,60,102,1.4285714285714286,0,1.0,8.542717098
Mo,42,61,103,1.4523809523809523,0,0.0,8.508465718
Mo,42,62,104,1.4761904761904763,0,1.0,8.496732788
Mo,42,63,105,1.5,0,0.0,8.460844752
Mo,42,64,106,1.5238095238095237,0,1.0,8.447030113
Mo,42,65,107,1.5476190476190477,0,0.0,8.409221467
Mo,42,66,108,1.5714285714285714,0,1.0,8.393060435
Mo,42,67,109,1.5952380952380953,0,0.0,8.351708743
Mo,42,68,110,1.619047619047619,0,1.0,8.331477955
Mo,42,69,111,1.6428571428571428,0,0.0,8.286030802
Mo,42,70,112,1.6666666666666667,0,1.0,8.260864304
Mo,42,71,113,1.6904761904761905,0,0.0,8.214018779
Mo,42,72,114,1.7142857142857142,0,1.0,8.186633167
Mo,42,73,115,1.7380952380952381,0,0.0,8.140231104
Mo,42,74,116,1.7619047619047619,0,1.0,8.112702578
Mo,42,75,117,1.7857142857142858,0,0.0,8.068158205
Mo,42,76,118,1.8095238095238095,0,1.0,8.042386144
Mo,42,77,119,1.8333333333333333,0,0.0,7.998472613
Mo,42,78,120,1.8571428571428572,0,1.0,7.972822333
Mo,42,79,121,1.880952380952381,0,0.0,7.929934545
Mo,42,80,122,1.9047619047619047,0,1.0,7.90410591
Mo,42,81,123,1.9285714285714286,0,0.0,7.856478122
Mo,42,82,124,1.9523809523809523,1,1.0,7.827656379
Mo,42,84,126,2.0,0,1.0,7.712269405
Mo,42,86,128,2.0476190476190474,0,1.0,7.595455641
Mo,42,88,130,2.0952380952380953,0,1.0,7.481000285
Tc,43,40,83,0.9302325581395349,0,0.0,8.069089072
Tc,43,42,85,0.9767441860465116,0,0.0,8.222374706
Tc,43,43,86,1.0,0,-1.0,8.273512709
Tc,43,44,87,1.0232558139534884,0,0.0,8.34951477
Tc,43,45,88,1.0465116279069768,0,-1.0,8.393577443
Tc,43,46,89,1.069767441860465,0,0.0,8.461616416
Tc,43,47,90,1.0930232558139534,0,-1.0,8.499746956
Tc,43,48,91,1.1162790697674418,0,0.0,8.560805297
Tc,43,49,92,1.1395348837209303,0,-1.0,8.585427565
Tc,43,50,93,1.1627906976744187,1,0.0,8.63699986
Tc,43,51,94,1.186046511627907,0,-1.0,8.623592787
Tc,43,52,95,1.2093023255813953,0,0.0,8.635829526
Tc,43,53,96,1.2325581395348837,0,-1.0,8.620411896
Tc,43,54,97,1.255813953488372,0,0.0,8.625423381
Tc,43,55,98,1.2790697674418605,0,-1.0,8.60362398
Tc,43,56,99,1.302325581395349,0,0.0,8.604079111
Tc,43,57,100,1.3255813953488371,0,-1.0,8.57839334
Tc,43,58,101,1.3488372093023255,0,0.0,8.575580356
Tc,43,59,102,1.372093023255814,0,-1.0,8.546898235
Tc,43,60,103,1.3953488372093024,0,0.0,8.540841136
Tc,43,61,104,1.4186046511627908,0,-1.0,8.511301365
Tc,43,62,105,1.441860465116279,0,0.0,8.503925505
Tc,43,63,106,1.4651162790697674,0,-1.0,8.472435019
Tc,43,64,107,1.4883720930232558,0,0.0,8.462596327
Tc,43,65,108,1.5116279069767442,0,-1.0,8.428991769
Tc,43,66,109,1.5348837209302326,0,0.0,8.416609294
Tc,43,67,110,1.558139534883721,0,-1.0,8.379327136
Tc,43,68,111,1.5813953488372092,0,0.0,8.362735874
Tc,43,69,112,1.6046511627906976,0,-1.0,8.321078955
Tc,43,70,113,1.627906976744186,0,0.0,8.299279593
Tc,43,71,114,1.6511627906976745,0,-1.0,8.255793053
Tc,43,72,115,1.6744186046511629,0,0.0,8.231382626
Tc,43,73,116,1.697674418604651,0,-1.0,8.188326336
Tc,43,74,117,1.7209302325581395,0,0.0,8.164261949
Tc,43,75,118,1.744186046511628,0,-1.0,8.123061669
Tc,43,76,119,1.7674418604651163,0,0.0,8.100793563
Tc,43,77,120,1.7906976744186047,0,-1.0,8.060088875
Tc,43,78,121,1.813953488372093,0,0.0,8.037368884
Tc,43,79,122,1.8372093023255813,0,-1.0,7.997653082
Tc,43,80,123,1.8604651162790697,0,0.0,7.974743756
Tc,43,81,124,1.8837209302325582,0,-1.0,7.929891734
Tc,43,82,125,1.9069767441860466,1,0.0,7.903774824
Tc,43,84,127,1.9534883720930232,0,0.0,7.792114071
Tc,43,86,129,2.0,0,0.0,7.678934078
Tc,43,88,131,2.046511627906977,0,0.0,7.567933504
Tc,43,90,133,2.0930232558139537,0,0.0,7.456612609
Ru,44,41,85,0.9318181818181818,0,0.0,8.054325059
Ru,44,42,86,0.9545454545454546,0,1.0,8.150670093
Ru,44,43,87,0.9772727272727273,0,0.0,8.208186264
Ru,44,44,88,1.0,0,1.0,8.290092591
Ru,44,45,89,1.0227272727272727,0,0.0,8.34021109
Ru,44,46,90,1.0454545454545454,0,1.0,8.4139015
Ru,44,47,91,1.0681818181818181,0,0.0,8.457560956
Ru,44,48,92,1.0909090909090908,0,1.0,8.523759076
Ru,44,49,93,1.1136363636363635,0,0.0,8.553808022
Ru,44,50,94,1.1363636363636365,1,1.0,8.610418851
Ru,44,51,95,1.1590909090909092,0,0.0,8.601750063
Ru,44,52,96,1.1818181818181819,0,1.0,8.618405625
Ru,44,53,97,1.2045454545454546,0,0.0,8.609466031
Ru,44,54,98,1.2272727272727273,0,1.0,8.620571724
Ru,44,55,99,1.25,0,0.0,8.604887253
Ru,44,56,100,1.2727272727272727,0,1.0,8.61076795
Ru,44,57,101,1.2954545454545454,0,0.0,8.588690713
Ru,44,58,102,1.3181818181818181,0,1.0,8.588829471
Ru,44,59,103,1.3409090909090908,0,0.0,8.561990767
Ru,44,60,104,1.3636363636363635,0,1.0,8.557490221
Ru,44,61,105,1.3863636363636365,0,0.0,8.532089581
Ru,44,62,106,1.4090909090909092,0,1.0,8.528515811
Ru,44,63,107,1.4318181818181819,0,0.0,8.501103402
Ru,44,64,108,1.4545454545454546,0,1.0,8.494934907
Ru,44,65,109,1.4772727272727273,0,0.0,8.465230156
Ru,44,66,110,1.5,0,1.0,8.456335218
Ru,44,67,111,1.5227272727272727,0,0.0,8.422816982
Ru,44,68,112,1.5454545454545454,0,1.0,8.409572741
Ru,44,69,113,1.5681818181818181,0,0.0,8.371376469
Ru,44,70,114,1.5909090909090908,0,1.0,8.352627877
Ru,44,71,115,1.6136363636363635,0,0.0,8.312137122
Ru,44,72,116,1.6363636363636365,0,1.0,8.29035156
Ru,44,73,117,1.6590909090909092,0,0.0,8.250530675
Ru,44,74,118,1.6818181818181819,0,1.0,8.229819924
Ru,44,75,119,1.7045454545454546,0,0.0,8.191750899
Ru,44,76,120,1.7272727272727273,0,1.0,8.1727748
Ru,44,77,121,1.75,0,0.0,8.13505824
Ru,44,78,122,1.7727272727272727,0,1.0,8.115056016
Ru,44,79,123,1.7954545454545454,0,0.0,8.078286984
Ru,44,80,124,1.8181818181818181,0,1.0,8.05807946
Ru,44,81,125,1.8409090909090908,0,0.0,8.015824552
Ru,44,82,126,1.8636363636363635,1,1.0,7.992237786
Ru,44,83,127,1.8863636363636365,0,0.0,7.929857843
Ru,44,84,128,1.9090909090909092,0,1.0,7.883940594
Ru,44,85,129,1.9318181818181819,0,0.0,7.822954372
Ru,44,86,130,1.9545454545454546,0,1.0,7.773946477
Ru,44,88,132,2.0,0,1.0,7.665978273
Ru,44,90,134,2.0454545454545454,0,1.0,7.557040284
Ru,44,92,136,2.090909090909091,0,1.0,7.446173324
Ru,44,98,142,2.227272727272727,0,1.0,7.12615338
Rh,45,42,87,0.9333333333333333,0,0.0,8.046962184
Rh,45,44,89,0.9777777777777777,0,0.0,8.198958326
Rh,45,45,90,1.0,0,-1.0,8.256678789
Rh,45,46,91,1.0222222222222221,0,0.0,8.337336714
Rh,45,47,92,1.0444444444444445,0,-1.0,8.385715478
Rh,45,48,93,1.0666666666666667,0,0.0,8.455967538
Rh,45,49,94,1.0888888888888888,0,-1.0,8.491916277
Rh,45,50,95,1.1111111111111112,1,0.0,8.553949484
Rh,45,51,96,1.1333333333333333,0,-1.0,8.550363625
Rh,45,52,97,1.1555555555555554,0,0.0,8.571787361
Rh,45,53,98,1.1777777777777778,0,-1.0,8.569368133
Rh,45,54,99,1.2,0,0.0,8.586566273
Rh,45,55,100,1.2222222222222223,0,-1.0,8.57608056
Rh,45,56,101,1.2444444444444445,0,0.0,8.58671999
Rh,45,57,102,1.2666666666666666,0,-1.0,8.569443588
Rh,45,58,103,1.288888888888889,0,0.0,8.574026078
Rh,45,59,104,1.3111111111111111,0,-1.0,8.551636308
Rh,45,60,105,1.3333333333333333,0,0.0,8.551363067
Rh,45,61,106,1.3555555555555556,0,-1.0,8.528162953
Rh,45,62,107,1.3777777777777778,0,0.0,8.52695614
Rh,45,63,108,1.4,0,-1.0,8.501543407
Rh,45,64,109,1.4222222222222223,0,0.0,8.497824817
Rh,45,65,110,1.4444444444444444,0,-1.0,8.471662391
Rh,45,66,111,1.4666666666666666,0,0.0,8.466363559
Rh,45,67,112,1.488888888888889,0,-1.0,8.436658179
Rh,45,68,113,1.511111111111111,0,0.0,8.426888991
Rh,45,69,114,1.5333333333333334,0,-1.0,8.392080632
Rh,45,70,115,1.5555555555555556,0,0.0,8.37684947
Rh,45,71,116,1.5777777777777777,0,-1.0,8.340259724
Rh,45,72,117,1.6,0,0.0,8.323184564
Rh,45,73,118,1.6222222222222222,0,-1.0,8.287663593
Rh,45,74,119,1.6444444444444444,0,0.0,8.271654462
Rh,45,75,120,1.6666666666666667,0,-1.0,8.236891608
Rh,45,76,121,1.6888888888888889,0,0.0,8.221019843
Rh,45,77,122,1.711111111111111,0,-1.0,8.186460262
Rh,45,78,123,1.7333333333333334,0,0.0,8.169446024
Rh,45,79,124,1.7555555555555555,0,-1.0,8.135614298
Rh,45,80,125,1.7777777777777777,0,0.0,8.118137584
Rh,45,81,126,1.8,0,-1.0,8.078733254
Rh,45,82,127,1.8222222222222222,1,0.0,8.057882575
Rh,45,83,128,1.8444444444444446,0,-1.0,7.997427359
Rh,45,84,129,1.8666666666666667,0,0.0,7.95339114
Rh,45,85,130,1.8888888888888888,0,-1.0,7.894347838
Rh,45,86,131,1.9111111111111112,0,0.0,7.847168817
Rh,45,87,132,1.9333333333333333,0,-1.0,7.788624273
Rh,45,88,133,1.9555555555555555,0,0.0,7.742778248
Rh,45,90,135,2.0,0,0.0,7.636900444
Rh,45,92,137,2.0444444444444443,0,0.0,7.53101492
Rh,45,94,139,2.088888888888889,0,0.0,7.424698741
Rh,45,96,141,2.1333333333333333,0,0.0,7.319757915
Rh,45,98,143,2.1777777777777776,0,0.0,7.220394063
Rh,45,100,145,2.2222222222222223,0,0.0,7.120909021
Pd,46,42,88,0.9130434782608695,0,1.0,7.968790932
Pd,46,43,89,0.9347826086956522,0,0.0,8.038830337
Pd,46,44,90,0.9565217391304348,0,1.0,8.132389233
Pd,46,45,91,0.9782608695652174,0,0.0,8.196972626
Pd,46,46,92,1.0,0,1.0,8.283888848
Pd,46,47,93,1.0217391304347827,0,0.0,8.336534
Pd,46,48,94,1.0434782608695652,0,1.0,8.410410872
Pd,46,49,95,1.065217391304348,0,0.0,8.451717726
Pd,46,50,96,1.0869565217391304,1,1.0,8.518652875
Pd,46,51,97,1.108695652173913,0,0.0,8.519679103
Pd,46,52,98,1.1304347826086956,0,1.0,8.545416194
Pd,46,53,99,1.1521739130434783,0,0.0,8.549204838
Pd,46,54,100,1.173913043478261,0,1.0,8.57219771
Pd,46,55,101,1.1956521739130435,0,0.0,8.566790248
Pd,46,56,102,1.2173913043478262,0,1.0,8.582078873
Pd,46,57,103,1.2391304347826086,0,0.0,8.569343136
Pd,46,58,104,1.2608695652173914,0,1.0,8.578121048
Pd,46,59,105,1.2826086956521738,0,0.0,8.559792895
Pd,46,60,106,1.3043478260869565,0,1.0,8.563371104
Pd,46,61,107,1.326086956521739,0,0.0,8.541842766
Pd,46,62,108,1.3478260869565217,0,1.0,8.542480861
Pd,46,63,109,1.3695652173913044,0,0.0,8.518809257
Pd,46,64,110,1.391304347826087,0,1.0,8.517278555
Pd,46,65,111,1.4130434782608696,0,0.0,8.493945432
Pd,46,66,112,1.434782608695652,0,1.0,8.491541446
Pd,46,67,113,1.4565217391304348,0,0.0,8.465370168
Pd,46,68,114,1.4782608695652173,0,1.0,8.458808088
Pd,46,69,115,1.5,0,0.0,8.427522748
Pd,46,70,116,1.5217391304347827,0,1.0,8.415939578
Pd,46,71,117,1.5434782608695652,0,0.0,8.382718521
Pd,46,72,118,1.565217391304348,0,1.0,8.36981672
Pd,46,73,119,1.5869565217391304,0,0.0,8.338498891
Pd,46,74,120,1.608695652173913,0,1.0,8.327089542
Pd,46,75,121,1.6304347826086956,0,0.0,8.295400008
Pd,46,76,122,1.6521739130434783,0,1.0,8.282406844
Pd,46,77,123,1.673913043478261,0,0.0,8.250803488
Pd,46,78,124,1.6956521739130435,0,1.0,8.236582452
Pd,46,79,125,1.7173913043478262,0,0.0,8.205479336
Pd,46,80,126,1.7391304347826086,0,1.0,8.19053131
Pd,46,81,127,1.7608695652173914,0,0.0,8.153768693
Pd,46,82,128,1.7826086956521738,1,1.0,8.135450289
Pd,46,83,129,1.8043478260869565,0,0.0,8.07676138
Pd,46,84,130,1.826086956521739,0,1.0,8.034450869
Pd,46,85,131,1.8478260869565217,0,0.0,7.977159725
Pd,46,86,132,1.8695652173913044,0,1.0,7.931623424
Pd,46,87,133,1.891304347826087,0,0.0,7.874722932
Pd,46,88,134,1.9130434782608696,0,1.0,7.830478746
Pd,46,90,136,1.9565217391304348,0,1.0,7.727307184
Pd,46,92,138,2.0,0,1.0,7.626192
Pd,46,94,140,2.0434782608695654,0,1.0,7.524000686
Pd,46,96,142,2.0869565217391304,0,1.0,7.422334261
Pd,46,98,144,2.130434782608696,0,1.0,7.324601063
Pd,46,100,146,2.1739130434782608,0,1.0,7.227763548
Ag,47,44,91,0.9361702127659575,0,0.0,8.03612644
Ag,47,46,93,0.9787234042553191,0,0.0,8.196571183
Ag,47,47,94,1.0,0,-1.0,8.256307287
Ag,47,48,95,1.0212765957446808,0,0.0,8.336733789
Ag,47,49,96,1.0425531914893618,0,-1.0,8.383670667
Ag,47,50,97,1.0638297872340425,1,0.0,8.455811701
Ag,47,51,98,1.0851063829787233,0,-1.0,8.461702531
Ag,47,52,99,1.1063829787234043,0,0.0,8.492028253
Ag,47,53,100,1.127659574468085,0,-1.0,8.4984631
Ag,47,54,101,1.148936170212766,0,0.0,8.523899545
Ag,47,55,102,1.1702127659574468,0,-1.0,8.522794461
Ag,47,56,103,1.1914893617021276,0,0.0,8.542134573
Ag,47,57,104,1.2127659574468086,0,-1.0,8.534130712
Ag,47,58,105,1.2340425531914894,0,0.0,8.547362667
Ag,47,59,106,1.2553191489361701,0,-1.0,8.533827509
Ag,47,60,107,1.2765957446808511,0,0.0,8.541969598
Ag,47,61,108,1.297872340425532,0,-1.0,8.524904352
Ag,47,62,109,1.3191489361702127,0,0.0,8.529814578
Ag,47,63,110,1.3404255319148937,0,-1.0,8.510011127
Ag,47,64,111,1.3617021276595744,0,0.0,8.51224591
Ag,47,65,112,1.3829787234042554,0,-1.0,8.491270455
Ag,47,66,113,1.4042553191489362,0,0.0,8.491716035
Ag,47,67,114,1.425531914893617,0,-1.0,8.467812807
Ag,47,68,115,1.446808510638298,0,0.0,8.464566896
Ag,47,69,116,1.4680851063829787,0,-1.0,8.43774581
Ag,47,70,117,1.4893617021276595,0,0.0,8.431444427
Ag,47,71,118,1.5106382978723405,0,-1.0,8.403541347
Ag,47,72,119,1.5319148936170213,0,0.0,8.396129059
Ag,47,73,120,1.553191489361702,0,-1.0,8.368205242
Ag,47,74,121,1.574468085106383,0,0.0,8.360050818
Ag,47,75,122,1.5957446808510638,0,-1.0,8.331489156
Ag,47,76,123,1.6170212765957446,0,0.0,8.321466228
Ag,47,77,124,1.6382978723404256,0,-1.0,8.292951113
Ag,47,78,125,1.6595744680851063,0,0.0,8.281603464
Ag,47,79,126,1.6808510638297873,0,-1.0,8.253419024
Ag,47,80,127,1.702127659574468,0,0.0,8.241134197
Ag,47,81,128,1.7234042553191489,0,-1.0,8.207258805
Ag,47,82,129,1.7446808510638299,1,0.0,8.191687791
Ag,47,83,130,1.7659574468085106,0,-1.0,8.134988769
Ag,47,84,131,1.7872340425531914,0,0.0,8.094612053
Ag,47,85,132,1.8085106382978724,0,-1.0,8.039265553
Ag,47,86,133,1.8297872340425532,0,0.0,7.995552045
Ag,47,87,134,1.851063829787234,0,-1.0,7.940493396
Ag,47,88,135,1.872340425531915,0,0.0,7.898018563
Ag,47,89,136,1.8936170212765957,0,-1.0,7.841230294
Ag,47,90,137,1.9148936170212767,0,0.0,7.798141
Ag,47,92,139,1.9574468085106382,0,0.0,7.698139547
Ag,47,94,141,2.0,0,0.0,7.599124489
Ag,47,96,143,2.0425531914893615,0,0.0,7.500497189
Ag,47,98,145,2.0851063829787235,0,0.0,7.406555683
Ag,47,100,147,2.127659574468085,0,0.0,7.313549878
Ag,47,102,149,2.1702127659574466,0,0.0,7.218970047
Ag,47,104,151,2.2127659574468086,0,0.0,7.123674728
Cd,48,44,92,0.9166666666666666,0,1.0,7.96306887
Cd,48,45,93,0.9375,0,0.0,8.036437667
Cd,48,46,94,0.9583333333333334,0,1.0,8.131144649
Cd,48,47,95,0.9791666666666666,0,0.0,8.197472063
Cd,48,48,96,1.0,0,1.0,8.283970219
Cd,48,49,97,1.0208333333333333,0,0.0,8.336035515
Cd,48,50,98,1.0416666666666667,1,1.0,8.412899724
Cd,48,51,99,1.0625,0,0.0,8.423211556
Cd,48,52,100,1.0833333333333333,0,1.0,8.45769672
Cd,48,53,101,1.1041666666666667,0,0.0,8.466511356
Cd,48,54,102,1.125,0,1.0,8.494134137
Cd,48,55,103,1.1458333333333333,0,0.0,8.49735865
Cd,48,56,104,1.1666666666666667,0,1.0,8.520781788
Cd,48,57,105,1.1875,0,0.0,8.517475705
Cd,48,58,106,1.2083333333333333,0,1.0,8.535133491
Cd,48,59,107,1.2291666666666667,0,0.0,8.526178579
Cd,48,60,108,1.25,0,1.0,8.538679972
Cd,48,61,109,1.2708333333333333,0,0.0,8.525784138
Cd,48,62,110,1.2916666666666667,0,1.0,8.534681618
Cd,48,63,111,1.3125,0,0.0,8.518465396
Cd,48,64,112,1.3333333333333333,0,1.0,8.524191598
Cd,48,65,113,1.3541666666666667,0,0.0,8.504800071
Cd,48,66,114,1.375,0,1.0,8.507326421
Cd,48,67,115,1.3958333333333333,0,0.0,8.485029783
Cd,48,68,116,1.4166666666666667,0,1.0,8.484431897
Cd,48,69,117,1.4375,0,0.0,8.462277436
Cd,48,70,118,1.4583333333333333,0,1.0,8.461442907
Cd,48,71,119,1.4791666666666667,0,0.0,8.438333378
Cd,48,72,120,1.5,0,1.0,8.435892042
Cd,48,73,121,1.5208333333333333,0,0.0,8.411095967
Cd,48,74,122,1.5416666666666667,0,1.0,8.405936852
Cd,48,75,123,1.5625,0,0.0,8.380252626
Cd,48,76,124,1.5833333333333333,0,1.0,8.372956073
Cd,48,77,125,1.6041666666666667,0,0.0,8.347337336
Cd,48,78,126,1.625,0,1.0,8.338677675
Cd,48,79,127,1.6458333333333333,0,0.0,8.31322326
Cd,48,80,128,1.6666666666666667,0,1.0,8.303419914
Cd,48,81,129,1.6875,0,0.0,8.272215163
Cd,48,82,130,1.7083333333333333,1,1.0,8.259180408
Cd,48,83,131,1.7291666666666667,0,0.0,8.204323595
Cd,48,84,132,1.75,0,1.0,8.165736061
Cd,48,85,133,1.7708333333333333,0,0.0,8.112186226
Cd,48,86,134,1.7916666666666667,0,1.0,8.07015156
Cd,48,87,135,1.8125,0,0.0,8.016793622
Cd,48,88,136,1.8333333333333333,0,1.0,7.97595014
Cd,48,89,137,1.8541666666666667,0,0.0,7.920631321
Cd,48,90,138,1.875,0,1.0,7.879059196
Cd,48,91,139,1.8958333333333333,0,0.0,7.822382489
Cd,48,92,140,1.9166666666666667,0,1.0,7.780109393
Cd,48,93,141,1.9375,0,0.0,7.72496995
Cd,48,94,142,1.9583333333333333,0,1.0,7.684443246
Cd,48,96,144,2.0,0,1.0,7.589024083
Cd,48,98,146,2.0416666666666665,0,1.0,7.498331815
Cd,48,100,148,2.0833333333333335,0,1.0,7.408800939
Cd,48,102,150,2.125,0,1.0,7.31712514
Cd,48,104,152,2.1666666666666665,0,1.0,7.224095618
Cd,48,106,154,2.2083333333333335,0,1.0,7.132013429
Cd,48,108,156,2.25,0,1.0,7.041912365
Cd,48,110,158,2.2916666666666665,0,1.0,6.9530815
In,49,46,95,0.9387755102040817,0,0.0,8.034429316
In,49,48,97,0.9795918367346939,0,0.0,8.19793667
In,49,49,98,1.0,0,-1.0,8.255288398
In,49,50,99,1.0204081632653061,1,0.0,8.337046242
In,49,51,100,1.0408163265306123,0,-1.0,8.35225369
In,49,52,101,1.0612244897959184,0,0.0,8.391363624
In,49,53,102,1.0816326530612246,0,-1.0,8.402969892
In,49,54,103,1.1020408163265305,0,0.0,8.433348408
In,49,55,104,1.1224489795918366,0,-1.0,8.438793875
In,49,56,105,1.1428571428571428,0,0.0,8.464764829
In,49,57,106,1.163265306122449,0,-1.0,8.465209
In,49,58,107,1.183673469387755,0,0.0,8.486890327
In,49,59,108,1.2040816326530612,0,-1.0,8.481850083
In,49,60,109,1.2244897959183674,0,0.0,8.498358358
In,49,61,110,1.2448979591836735,0,-1.0,8.490219891
In,49,62,111,1.2653061224489797,0,0.0,8.50390991
In,49,63,112,1.2857142857142858,0,-1.0,8.492364125
In,49,64,113,1.3061224489795917,0,0.0,8.50262808
In,49,65,114,1.3265306122448979,0,-1.0,8.487941763
In,49,66,115,1.346938775510204,0,0.0,8.494966574
In,49,67,116,1.3673469387755102,0,-1.0,8.477897853
In,49,68,117,1.3877551020408163,0,0.0,8.482454291
In,49,69,118,1.4081632653061225,0,-1.0,8.464214331
In,49,70,119,1.4285714285714286,0,0.0,8.467263025
In,49,71,120,1.4489795918367347,0,-1.0,8.447439658
In,49,72,121,1.469387755102041,0,0.0,8.44809814
In,49,73,122,1.489795918367347,0,-1.0,8.42663118
In,49,74,123,1.510204081632653,0,0.0,8.424573959
In,49,75,124,1.530612244897959,0,-1.0,8.402168121
In,49,76,125,1.5510204081632653,0,0.0,8.397933976
In,49,77,126,1.5714285714285714,0,-1.0,8.375348873
In,49,78,127,1.5918367346938775,0,0.0,8.369508079
In,49,79,128,1.6122448979591837,0,-1.0,8.347004133
In,49,80,129,1.6326530612244898,0,0.0,8.339905488
In,49,81,130,1.653061224489796,0,-1.0,8.311581877
In,49,82,131,1.6734693877551021,1,0.0,8.301294695
In,49,83,132,1.6938775510204083,0,-1.0,8.24852947
In,49,84,133,1.7142857142857142,0,0.0,8.211971541
In,49,85,134,1.7346938775510203,0,-1.0,8.160453194
In,49,86,135,1.7551020408163265,0,0.0,8.120347007
In,49,87,136,1.7755102040816326,0,-1.0,8.068902912
In,49,88,137,1.7959183673469388,0,0.0,8.029908883
In,49,89,138,1.816326530612245,0,-1.0,7.976379326
In,49,90,139,1.836734693877551,0,0.0,7.936600561
In,49,91,140,1.8571428571428572,0,-1.0,7.880856171
In,49,92,141,1.8775510204081634,0,0.0,7.839699305
In,49,93,142,1.8979591836734695,0,-1.0,7.785018232
In,49,94,143,1.9183673469387754,0,0.0,7.745150951
In,49,95,144,1.9387755102040816,0,-1.0,7.692400896
In,49,96,145,1.9591836734693877,0,0.0,7.654149269
In,49,97,146,1.9795918367346939,0,-1.0,7.604452068
In,49,98,147,2.0,0,0.0,7.568413136
In,49,99,148,2.020408163265306,0,-1.0,7.518938703
In,49,100,149,2.0408163265306123,0,0.0,7.48259996
In,49,102,151,2.0816326530612246,0,0.0,7.394502159
In,49,104,153,2.122448979591837,0,0.0,7.304430608
In,49,106,155,2.163265306122449,0,0.0,7.214517381
In,49,108,157,2.204081632653061,0,0.0,7.126207197
In,49,110,159,2.2448979591836733,0,0.0,7.039142962
In,49,112,161,2.2857142857142856,0,0.0,6.952390876
In,49,118,167,2.4081632653061225,0,0.0,6.703927599
In,49,120,169,2.4489795918367347,0,0.0,6.626180183
In,49,122,171,2.489795918367347,0,0.0,6.551015982
In,49,124,173,2.5306122448979593,0,0.0,6.477688468
Sn,50,46,96,0.92,1,1.0,7.964065031
Sn,50,47,97,0.94,1,0.0,8.041194649
Sn,50,48,98,0.96,1,1.0,8.137533143
Sn,50,49,99,0.98,1,0.0,8.199810293
Sn,50,50,100,1.0,1,1.0,8.28611583
Sn,50,51,101,1.02,1,0.0,8.305772257
Sn,50,52,102,1.04,1,1.0,8.349074402
Sn,50,53,103,1.06,1,0.0,8.363084641
Sn,50,54,104,1.08,1,1.0,8.395839375
Sn,50,55,105,1.1,1,0.0,8.403379371
Sn,50,56,106,1.12,1,1.0,8.431767934
Sn,50,57,107,1.14,1,0.0,8.434280421
Sn,50,58,108,1.16,1,1.0,8.458329444
Sn,50,59,109,1.18,1,0.0,8.457763385
Sn,50,60,110,1.2,1,1.0,8.478826218
Sn,50,61,111,1.22,1,0.0,8.475041595
Sn,50,62,112,1.24,1,1.0,8.493127214
Sn,50,63,113,1.26,1,0.0,8.485959646
Sn,50,64,114,1.28,1,1.0,8.500476588
Sn,50,65,115,1.3,1,0.0,8.49031593
Sn,50,66,116,1.32,1,1.0,8.501666328
Sn,50,67,117,1.34,1,0.0,8.489749137
Sn,50,68,118,1.36,1,1.0,8.499386008
Sn,50,69,119,1.38,1,0.0,8.48485105
Sn,50,70,120,1.4,1,1.0,8.491577458
Sn,50,71,121,1.42,1,0.0,8.474770264
Sn,50,72,122,1.44,1,1.0,8.478266066
Sn,50,73,123,1.46,1,0.0,8.459876593
Sn,50,74,124,1.48,1,1.0,8.460677355
Sn,50,75,125,1.5,1,0.0,8.44130336
Sn,50,76,126,1.52,1,1.0,8.439892405
Sn,50,77,127,1.54,1,0.0,8.420127984
Sn,50,78,128,1.56,1,1.0,8.416899773
Sn,50,79,129,1.58,1,0.0,8.397138124
Sn,50,80,130,1.6,1,1.0,8.392542977
Sn,50,81,131,1.62,1,0.0,8.366871802
Sn,50,82,132,1.64,1,1.0,8.359108977
Sn,50,83,133,1.66,1,0.0,8.308223015
Sn,50,84,134,1.68,1,1.0,8.27348644
Sn,50,85,135,1.7,1,0.0,8.223786748
Sn,50,86,136,1.72,1,1.0,8.185400824
Sn,50,87,137,1.74,1,0.0,8.135659219
Sn,50,88,138,1.76,1,1.0,8.09830729
Sn,50,89,139,1.78,1,0.0,8.046351158
Sn,50,90,140,1.8,1,1.0,8.008152921
Sn,50,91,141,1.82,1,0.0,7.953166801
Sn,50,92,142,1.84,1,1.0,7.912951986
Sn,50,94,144,1.88,1,1.0,7.817115063
Sn,50,95,145,1.9,1,0.0,7.766312462
Sn,50,96,146,1.92,1,1.0,7.729569164
Sn,50,97,147,1.94,1,0.0,7.682524184
Sn,50,98,148,1.96,1,1.0,7.648518676
Sn,50,99,149,1.98,1,0.0,7.600960792
Sn,50,100,150,2.0,1,1.0,7.566292327
Sn,50,101,151,2.02,1,0.0,7.517564093
Sn,50,102,152,2.04,1,1.0,7.481535329
Sn,50,104,154,2.08,1,1.0,7.394164571
Sn,50,106,156,2.12,1,1.0,7.306188929
Sn,50,108,158,2.16,1,1.0,7.219462247
Sn,50,110,160,2.2,1,1.0,7.133934756
Sn,50,112,162,2.24,1,1.0,7.048496975
Sn,50,114,164,2.28,1,1.0,6.966289963
Sn,50,116,166,2.32,1,1.0,6.887730825
Sn,50,118,168,2.36,1,1.0,6.81202228
Sn,50,120,170,2.4,1,1.0,6.737840406
Sn,50,122,172,2.44,1,1.0,6.664865756
Sn,50,124,174,2.48,1,1.0,6.593800644
Sb,51,52,103,1.0196078431372548,0,0.0,8.242899427
Sb,51,54,105,1.0588235294117647,0,0.0,8.30531339
Sb,51,56,107,1.0980392156862746,0,0.0,8.354256916
Sb,51,57,108,1.1176470588235294,0,-1.0,8.363120898
Sb,51,58,109,1.1372549019607843,0,0.0,8.392432835
Sb,51,59,110,1.1568627450980393,0,-1.0,8.395415273
Sb,51,60,111,1.1764705882352942,0,0.0,8.419143649
Sb,51,61,112,1.196078431372549,0,-1.0,8.419479812
Sb,51,62,113,1.2156862745098038,0,0.0,8.440474867
Sb,51,63,114,1.2352941176470589,0,-1.0,8.438198325
Sb,51,64,115,1.2549019607843137,0,0.0,8.456389565
Sb,51,65,116,1.2745098039215685,0,-1.0,8.450474828
Sb,51,66,117,1.2941176470588236,0,0.0,8.465061915
Sb,51,67,118,1.3137254901960784,0,-1.0,8.455752703
Sb,51,68,119,1.3333333333333333,0,0.0,8.46677637
Sb,51,69,120,1.3529411764705883,0,-1.0,8.454887025
Sb,51,70,121,1.3725490196078431,0,0.0,8.462973521
Sb,51,71,122,1.392156862745098,0,-1.0,8.449183451
Sb,51,72,123,1.411764705882353,0,0.0,8.454683285
Sb,51,73,124,1.4313725490196079,0,-1.0,8.438892121
Sb,51,74,125,1.4509803921568627,0,0.0,8.44155084
Sb,51,75,126,1.4705882352941178,0,-1.0,8.424932349
Sb,51,76,127,1.4901960784313726,0,0.0,8.425829874
Sb,51,77,128,1.5098039215686274,0,-1.0,8.408885406
Sb,51,78,129,1.5294117647058822,0,0.0,8.408224543
Sb,51,79,130,1.5490196078431373,0,-1.0,8.391555469
Sb,51,80,131,1.5686274509803921,0,0.0,8.389811092
Sb,51,81,132,1.588235294117647,0,-1.0,8.367174538
Sb,51,82,133,1.607843137254902,1,0.0,8.36228803
Sb,51,83,134,1.6274509803921569,0,-1.0,8.313975455
Sb,51,84,135,1.6470588235294117,0,0.0,8.281741563
Sb,51,85,136,1.6666666666666667,0,-1.0,8.236027338
Sb,51,86,137,1.6862745098039216,0,0.0,8.201643139
Sb,51,87,138,1.7058823529411764,0,-1.0,8.154951377
Sb,51,88,139,1.7254901960784315,0,0.0,8.120633194
Sb,51,89,140,1.7450980392156863,0,-1.0,8.0719546
Sb,51,90,141,1.7647058823529411,0,0.0,8.036649262
Sb,51,91,142,1.7843137254901962,0,-1.0,7.985780915
Sb,51,92,143,1.803921568627451,0,0.0,7.949008042
Sb,51,93,144,1.8235294117647058,0,-1.0,7.898987646
Sb,51,94,145,1.8431372549019607,0,0.0,7.863166131
Sb,51,95,146,1.8627450980392157,0,-1.0,7.815855493
Sb,51,96,147,1.8823529411764706,0,0.0,7.782091558
Sb,51,97,148,1.9019607843137254,0,-1.0,7.736542541
Sb,51,98,149,1.9215686274509804,0,0.0,7.703886758
Sb,51,99,150,1.9411764705882353,0,-1.0,7.658237687
Sb,51,100,151,1.9607843137254901,0,0.0,7.625296623
Sb,51,101,152,1.9803921568627452,0,-1.0,7.578660684
Sb,51,102,153,2.0,0,0.0,7.544532294
Sb,51,103,154,2.019607843137255,0,-1.0,7.496557318
Sb,51,104,155,2.0392156862745097,0,0.0,7.460725123
Sb,51,106,157,2.0784313725490198,0,0.0,7.375616268
Sb,51,108,159,2.1176470588235294,0,0.0,7.291501453
Sb,51,110,161,2.156862745098039,0,0.0,7.208720056
Sb,51,112,163,2.196078431372549,0,0.0,7.126245626
Sb,51,114,165,2.235294117647059,0,0.0,7.043975127
Sb,51,116,167,2.2745098039215685,0,0.0,6.965518695
Sb,51,118,169,2.3137254901960786,0,0.0,6.890287473
Sb,51,120,171,2.3529411764705883,0,0.0,6.816885632
Sb,51,122,173,2.392156862745098,0,0.0,6.74543596
Sb,51,124,175,2.4313725490196076,0,0.0,6.677279063
Sb,51,126,177,2.4705882352941178,1,0.0,6.603817853
Te,52,53,105,1.0192307692307692,0,0.0,8.190344133
Te,52,54,106,1.0384615384615385,0,1.0,8.237828811
Te,52,55,107,1.0576923076923077,0,0.0,8.259243682
Te,52,56,108,1.0769230769230769,0,1.0,8.2992095
Te,52,57,109,1.0961538461538463,0,0.0,8.312548771
Te,52,58,110,1.1153846153846154,0,1.0,8.3453013
Te,52,59,111,1.1346153846153846,0,0.0,8.35230318
Te,52,60,112,1.1538461538461537,0,1.0,8.379175402
Te,52,61,113,1.1730769230769231,0,0.0,8.383226018
Te,52,62,114,1.1923076923076923,0,1.0,8.406752544
Te,52,63,115,1.2115384615384615,0,0.0,8.40887207
Te,52,64,116,1.2307692307692308,0,1.0,8.430272164
Te,52,65,117,1.25,0,0.0,8.428591376
Te,52,66,118,1.2692307692307692,0,1.0,8.446420492
Te,52,67,119,1.2884615384615385,0,0.0,8.440137395
Te,52,68,120,1.3076923076923077,0,1.0,8.45297935
Te,52,69,121,1.3269230769230769,0,0.0,8.44349157
Te,52,70,122,1.3461538461538463,0,1.0,8.45271918
Te,52,71,123,1.3653846153846154,0,0.0,8.441748911
Te,52,72,124,1.3846153846153846,0,1.0,8.449074984
Te,52,73,125,1.4038461538461537,0,0.0,8.435711424
Te,52,74,126,1.4230769230769231,0,1.0,8.440071865
Te,52,75,127,1.4423076923076923,0,0.0,8.426110772
Te,52,76,128,1.4615384615384615,0,1.0,8.429227164
Te,52,77,129,1.4807692307692308,0,0.0,8.415002171
Te,52,78,130,1.5,0,1.0,8.416813592
Te,52,79,131,1.5192307692307692,0,0.0,8.40303774
Te,52,80,132,1.5384615384615385,0,1.0,8.403951462
Te,52,81,133,1.5576923076923077,0,0.0,8.38413588
Te,52,82,134,1.5769230769230769,1,1.0,8.381917567
Te,52,83,135,1.5961538461538463,0,0.0,8.335930015
Te,52,84,136,1.6153846153846154,0,1.0,8.305955103
Te,52,85,137,1.6346153846153846,0,0.0,8.263730365
Te,52,86,138,1.6538461538461537,0,1.0,8.232858848
Te,52,87,139,1.6730769230769231,0,0.0,8.189053209
Te,52,88,140,1.6923076923076923,0,1.0,8.157607614
Te,52,89,141,1.7115384615384615,0,0.0,8.112085121
Te,52,90,142,1.7307692307692308,0,1.0,8.079558352
Te,52,91,143,1.75,0,0.0,8.032710608
Te,52,92,144,1.7692307692307692,0,1.0,7.99929325
Te,52,93,145,1.7884615384615385,0,0.0,7.95330891
Te,52,94,146,1.8076923076923077,0,1.0,7.920723726
Te,52,95,147,1.8269230769230769,0,0.0,7.876064626
Te,52,96,148,1.8461538461538463,0,1.0,7.844457926
Te,52,97,149,1.8653846153846154,0,0.0,7.800283859
Te,52,98,150,1.8846153846153846,0,1.0,7.768860333
Te,52,99,151,1.9038461538461537,0,0.0,7.72502555
Te,52,100,152,1.9230769230769231,0,1.0,7.693720987
Te,52,101,153,1.9423076923076923,0,0.0,7.649085314
Te,52,102,154,1.9615384615384615,0,1.0,7.616768942
Te,52,103,155,1.9807692307692308,0,0.0,7.570563626
Te,52,104,156,2.0,0,1.0,7.53630716
Te,52,105,157,2.019230769230769,0,0.0,7.489268822
Te,52,106,158,2.0384615384615383,0,1.0,7.453782449
Te,52,107,159,2.0576923076923075,0,0.0,7.407163006
Te,52,108,160,2.076923076923077,0,1.0,7.371918713
Te,52,110,162,2.1153846153846154,0,1.0,7.291466
Te,52,112,164,2.1538461538461537,0,1.0,7.211520116
Te,52,114,166,2.1923076923076925,0,1.0,7.130749133
Te,52,116,168,2.230769230769231,0,1.0,7.053390042
Te,52,118,170,2.269230769230769,0,1.0,6.978328035
Te,52,120,172,2.3076923076923075,0,1.0,6.905310331
Te,52,122,174,2.3461538461538463,0,1.0,6.835285195
Te,52,123,175,2.3653846153846154,0,0.0,6.797162726
Te,52,124,176,2.3846153846153846,0,1.0,6.769744614
Te,52,126,178,2.423076923076923,1,1.0,6.698932382
I,53,56,109,1.0566037735849056,0,0.0,8.21772633
I,53,58,111,1.0943396226415094,0,0.0,8.273414072
I,53,59,112,1.1132075471698113,0,-1.0,8.285413107
I,53,60,113,1.1320754716981132,0,0.0,8.316471726
I,53,61,114,1.150943396226415,0,-1.0,8.325166465
I,53,62,115,1.169811320754717,0,0.0,8.352651365
I,53,63,116,1.1886792452830188,0,-1.0,8.358788802
I,53,64,117,1.2075471698113207,0,0.0,8.383351564
I,53,65,118,1.2264150943396226,0,-1.0,8.385860492
I,53,66,119,1.2452830188679245,0,0.0,8.406651748
I,53,67,120,1.2641509433962264,0,-1.0,8.404756992
I,53,68,121,1.2830188679245282,0,0.0,8.420822826
I,53,69,122,1.3018867924528301,0,-1.0,8.414714123
I,53,70,123,1.320754716981132,0,0.0,8.426279943
I,53,71,124,1.3396226415094339,0,-1.0,8.417614758
I,53,72,125,1.3584905660377358,0,0.0,8.426341776
I,53,73,126,1.3773584905660377,0,-1.0,8.415706833
I,53,74,127,1.3962264150943395,0,0.0,8.422028165
I,53,75,128,1.4150943396226414,0,-1.0,8.410720516
I,53,76,129,1.4339622641509433,0,0.0,8.415744271
I,53,77,130,1.4528301886792452,0,-1.0,8.403572231
I,53,78,131,1.471698113207547,0,0.0,8.406782168
I,53,79,132,1.490566037735849,0,-1.0,8.393550636
I,53,80,133,1.509433962264151,0,0.0,8.394663699
I,53,81,134,1.528301886792453,0,-1.0,8.377786328
I,53,82,135,1.5471698113207548,1,0.0,8.378349496
I,53,83,136,1.5660377358490567,0,-1.0,8.336356728
I,53,84,137,1.5849056603773586,0,0.0,8.310422942
I,53,85,138,1.6037735849056605,0,-1.0,8.272318319
I,53,86,139,1.6226415094339623,0,0.0,8.245541216
I,53,87,140,1.6415094339622642,0,-1.0,8.2053808
I,53,88,141,1.6603773584905661,0,0.0,8.177391645
I,53,89,142,1.679245283018868,0,-1.0,8.134917056
I,53,90,143,1.6981132075471699,0,0.0,8.105187287
I,53,91,144,1.7169811320754718,0,-1.0,8.061404382
I,53,92,145,1.7358490566037736,0,0.0,8.030640352
I,53,93,146,1.7547169811320755,0,-1.0,7.987590774
I,53,94,147,1.7735849056603774,0,0.0,7.957569333
I,53,95,148,1.7924528301886793,0,-1.0,7.915483946
I,53,96,149,1.8113207547169812,0,0.0,7.886182477
I,53,97,150,1.830188679245283,0,-1.0,7.844368673
I,53,98,151,1.849056603773585,0,0.0,7.815061146
I,53,99,152,1.8679245283018868,0,-1.0,7.773403007
I,53,100,153,1.8867924528301887,0,0.0,7.744040784
I,53,101,154,1.9056603773584906,0,-1.0,7.701434104
I,53,102,155,1.9245283018867925,0,0.0,7.670929032
I,53,103,156,1.9433962264150944,0,-1.0,7.626574545
I,53,104,157,1.9622641509433962,0,0.0,7.593982287
I,53,105,158,1.9811320754716981,0,-1.0,7.548563348
I,53,106,159,2.0,0,0.0,7.514513535
I,53,107,160,2.018867924528302,0,-1.0,7.469420056
I,53,108,161,2.0377358490566038,0,0.0,7.435497118
I,53,109,162,2.056603773584906,0,-1.0,7.391104642
I,53,110,163,2.0754716981132075,0,0.0,7.357841307
I,53,111,164,2.0943396226415096,0,-1.0,7.313721372
I,53,112,165,2.1132075471698113,0,0.0,7.280719691
I,53,114,167,2.150943396226415,0,0.0,7.202103784
I,53,116,169,2.188679245283019,0,0.0,7.124831852
I,53,118,171,2.2264150943396226,0,0.0,7.050427333
I,53,120,173,2.2641509433962264,0,0.0,6.979045474
I,53,121,174,2.2830188679245285,0,-1.0,6.939393621
I,53,122,175,2.30188679245283,0,0.0,6.910359217
I,53,123,176,2.3207547169811322,0,-1.0,6.873034216
I,53,124,177,2.339622641509434,0,0.0,6.846118542
I,53,126,179,2.3773584905660377,1,0.0,6.778100229
Xe,54,56,110,1.037037037037037,0,1.0,8.152949882
Xe,54,57,111,1.0555555555555556,0,0.0,8.176282613
Xe,54,58,112,1.0740740740740742,0,1.0,8.217889027
Xe,54,59,113,1.0925925925925926,0,0.0,8.234640478
Xe,54,60,114,1.1111111111111112,0,1.0,8.269659263
Xe,54,61,115,1.1296296296296295,0,0.0,8.28270253
Xe,54,62,116,1.1481481481481481,0,1.0,8.313867155
Xe,54,63,117,1.1666666666666667,0,0.0,8.323581598
Xe,54,64,118,1.1851851851851851,0,1.0,8.350888076
Xe,54,65,119,1.2037037037037037,0,0.0,8.357418176
Xe,54,66,120,1.2222222222222223,0,1.0,8.381026267
Xe,54,67,121,1.2407407407407407,0,0.0,8.383306347
Xe,54,68,122,1.2592592592592593,0,1.0,8.402405156
Xe,54,69,123,1.2777777777777777,0,0.0,8.39947565
Xe,54,70,124,1.2962962962962963,0,1.0,8.413199798
Xe,54,71,125,1.3148148148148149,0,0.0,8.406647416
Xe,54,72,126,1.3333333333333333,0,1.0,8.416600516
Xe,54,73,127,1.3518518518518519,0,0.0,8.408486425
Xe,54,74,128,1.3703703703703705,0,1.0,8.416576141
Xe,54,75,129,1.3888888888888888,0,0.0,8.407889845
Xe,54,76,130,1.4074074074074074,0,1.0,8.414800838
Xe,54,77,131,1.4259259259259258,0,0.0,8.404740336
Xe,54,78,132,1.4444444444444444,0,1.0,8.409416386
Xe,54,79,133,1.462962962962963,0,0.0,8.397043188
Xe,54,80,134,1.4814814814814814,0,1.0,8.39867009
Xe,54,81,135,1.5,0,0.0,8.384522133
Xe,54,82,136,1.5185185185185186,1,1.0,8.38766336
Xe,54,83,137,1.537037037037037,0,0.0,8.349154577
Xe,54,84,138,1.5555555555555556,0,1.0,8.326757862
Xe,54,85,139,1.5740740740740742,0,0.0,8.292121439
Xe,54,86,140,1.5925925925925926,0,1.0,8.2687965
Xe,54,87,141,1.6111111111111112,0,0.0,8.232085199
Xe,54,88,142,1.6296296296296295,0,1.0,8.207361803
Xe,54,89,143,1.6481481481481481,0,0.0,8.167852524
Xe,54,90,144,1.6666666666666667,0,1.0,8.140841806
Xe,54,91,145,1.6851851851851851,0,0.0,8.100111331
Xe,54,92,146,1.7037037037037037,0,1.0,8.071994027
Xe,54,93,147,1.7222222222222223,0,0.0,8.031759524
Xe,54,94,148,1.7407407407407407,0,1.0,8.00418877
Xe,54,95,149,1.7592592592592593,0,0.0,7.964365926
Xe,54,96,150,1.7777777777777777,0,1.0,7.93706624
Xe,54,97,151,1.7962962962962963,0,0.0,7.897399424
Xe,54,98,152,1.8148148148148149,0,1.0,7.870000638
Xe,54,99,153,1.8333333333333333,0,0.0,7.830396549
Xe,54,100,154,1.8518518518518519,0,1.0,7.802858695
Xe,54,101,155,1.8703703703703705,0,0.0,7.762203981
Xe,54,102,156,1.8888888888888888,0,1.0,7.733436955
Xe,54,103,157,1.9074074074074074,0,0.0,7.690850115
Xe,54,104,158,1.9259259259259258,0,1.0,7.659842297
Xe,54,105,159,1.9444444444444444,0,0.0,7.615930937
Xe,54,106,160,1.962962962962963,0,1.0,7.583209556
Xe,54,107,161,1.9814814814814814,0,0.0,7.539528335
Xe,54,108,162,2.0,0,1.0,7.506816994
Xe,54,109,163,2.0185185185185186,0,0.0,7.463853975
Xe,54,110,164,2.037037037037037,0,1.0,7.431813823
Xe,54,111,165,2.0555555555555554,0,0.0,7.389172145
Xe,54,112,166,2.074074074074074,0,1.0,7.357453627
Xe,54,113,167,2.0925925925925926,0,0.0,7.313949886
Xe,54,114,168,2.111111111111111,0,1.0,7.28124206
Xe,54,116,170,2.1481481481481484,0,1.0,7.203794312
Xe,54,118,172,2.185185185185185,0,1.0,7.129731285
Xe,54,119,173,2.2037037037037037,0,0.0,7.089594676
Xe,54,120,174,2.2222222222222223,0,1.0,7.059703569
Xe,54,121,175,2.240740740740741,0,0.0,7.021073343
Xe,54,122,176,2.259259259259259,0,1.0,6.992509148
Xe,54,123,177,2.2777777777777777,0,0.0,6.955937181
Xe,54,124,178,2.2962962962962963,0,1.0,6.929483326
Xe,54,125,179,2.314814814814815,0,0.0,6.890881536
Xe,54,126,180,2.3333333333333335,1,1.0,6.8640616
Cs,55,58,113,1.0545454545454545,0,0.0,8.138328929
Cs,55,60,115,1.0909090909090908,0,0.0,8.200632365
Cs,55,61,116,1.1090909090909091,0,-1.0,8.219151491
Cs,55,62,117,1.1272727272727272,0,0.0,8.254858359
Cs,55,63,118,1.1454545454545455,0,-1.0,8.268278424
Cs,55,64,119,1.1636363636363636,0,0.0,8.298383924
Cs,55,65,120,1.1818181818181819,0,-1.0,8.308490783
Cs,55,66,121,1.2,0,0.0,8.335031041
Cs,55,67,122,1.2181818181818183,0,-1.0,8.340836615
Cs,55,68,123,1.2363636363636363,0,0.0,8.363034333
Cs,55,69,124,1.2545454545454546,0,-1.0,8.363316839
Cs,55,70,125,1.2727272727272727,0,0.0,8.379820856
Cs,55,71,126,1.290909090909091,0,-1.0,8.375878984
Cs,55,72,127,1.309090909090909,0,0.0,8.387867701
Cs,55,73,128,1.3272727272727274,0,-1.0,8.381880211
Cs,55,74,129,1.3454545454545455,0,0.0,8.391467667
Cs,55,75,130,1.3636363636363635,0,-1.0,8.384933923
Cs,55,76,131,1.3818181818181818,0,0.0,8.393427763
Cs,55,77,132,1.4,0,-1.0,8.385720848
Cs,55,78,133,1.4181818181818182,0,0.0,8.392330286
Cs,55,79,134,1.4363636363636363,0,-1.0,8.382099328
Cs,55,80,135,1.4545454545454546,0,0.0,8.385565667
Cs,55,81,136,1.4727272727272727,0,-1.0,8.373005919
Cs,55,82,137,1.490909090909091,1,0.0,8.377552372
Cs,55,83,138,1.509090909090909,0,-1.0,8.342489464
Cs,55,84,139,1.5272727272727273,0,0.0,8.323386151
Cs,55,85,140,1.5454545454545454,0,-1.0,8.292047707
Cs,55,86,141,1.5636363636363637,0,0.0,8.271845816
Cs,55,87,142,1.5818181818181818,0,-1.0,8.238611296
Cs,55,88,143,1.6,0,0.0,8.21721486
Cs,55,89,144,1.6181818181818182,0,-1.0,8.180898222
Cs,55,90,145,1.6363636363636365,0,0.0,8.156892538
Cs,55,91,146,1.6545454545454545,0,-1.0,8.119410781
Cs,55,92,147,1.6727272727272726,0,0.0,8.094216163
Cs,55,93,148,1.690909090909091,0,-1.0,8.057378074
Cs,55,94,149,1.709090909090909,0,0.0,8.032769886
Cs,55,95,150,1.7272727272727273,0,-1.0,7.99565866
Cs,55,96,151,1.7454545454545454,0,0.0,7.97062194
Cs,55,97,152,1.7636363636363637,0,-1.0,7.933408586
Cs,55,98,153,1.7818181818181817,0,0.0,7.908070549
Cs,55,99,154,1.8,0,-1.0,7.870587474
Cs,55,100,155,1.8181818181818181,0,0.0,7.844868703
Cs,55,101,156,1.8363636363636364,0,-1.0,7.806012224
Cs,55,102,157,1.8545454545454545,0,0.0,7.778812357
Cs,55,103,158,1.8727272727272728,0,-1.0,7.737845854
Cs,55,104,159,1.8909090909090909,0,0.0,7.708293491
Cs,55,105,160,1.9090909090909092,0,-1.0,7.66586695
Cs,55,106,161,1.9272727272727272,0,0.0,7.634493969
Cs,55,107,162,1.9454545454545455,0,-1.0,7.592304216
Cs,55,108,163,1.9636363636363636,0,0.0,7.560919595
Cs,55,109,164,1.981818181818182,0,-1.0,7.519471451
Cs,55,110,165,2.0,0,0.0,7.488744188
Cs,55,111,166,2.018181818181818,0,-1.0,7.44761312
Cs,55,112,167,2.036363636363636,0,0.0,7.417183814
Cs,55,113,168,2.0545454545454547,0,-1.0,7.375022464
Cs,55,114,169,2.0727272727272728,0,0.0,7.343479982
Cs,55,115,170,2.090909090909091,0,-1.0,7.300410741
Cs,55,116,171,2.109090909090909,0,0.0,7.26757983
Cs,55,117,172,2.1272727272727274,0,-1.0,7.226124826
Cs,55,118,173,2.1454545454545455,0,0.0,7.194593717
Cs,55,119,174,2.1636363636363636,0,-1.0,7.155291356
Cs,55,120,175,2.1818181818181817,0,0.0,7.125801463
Cs,55,121,176,2.2,0,-1.0,7.088036898
Cs,55,122,177,2.2181818181818183,0,0.0,7.059936633
Cs,55,123,178,2.2363636363636363,0,-1.0,7.024439713
Cs,55,124,179,2.2545454545454544,0,0.0,6.998817849
Cs,55,125,180,2.272727272727273,0,-1.0,6.961538939
Cs,55,126,181,2.290909090909091,1,0.0,6.93603374
Ba,56,58,114,1.0357142857142858,0,1.0,8.075417281
Ba,56,59,115,1.0535714285714286,0,0.0,8.102964487
Ba,56,60,116,1.0714285714285714,0,1.0,8.147352741
Ba,56,61,117,1.0892857142857142,0,0.0,8.171104812
Ba,56,62,118,1.1071428571428572,0,1.0,8.211130949
Ba,56,63,119,1.125,0,0.0,8.228047403
Ba,56,64,120,1.1428571428571428,0,1.0,8.260761308
Ba,56,65,121,1.1607142857142858,0,0.0,8.274297025
Ba,56,66,122,1.1785714285714286,0,1.0,8.303634549
Ba,56,67,123,1.1964285714285714,0,0.0,8.31285335
Ba,56,68,124,1.2142857142857142,0,1.0,8.338046395
Ba,56,69,125,1.2321428571428572,0,0.0,8.341459992
Ba,56,70,126,1.25,0,1.0,8.360671103
Ba,56,71,127,1.2678571428571428,0,0.0,8.359123906
Ba,56,72,128,1.2857142857142858,0,1.0,8.372944773
Ba,56,73,129,1.3035714285714286,0,0.0,8.368777977
Ba,56,74,130,1.3214285714285714,0,1.0,8.379571654
Ba,56,75,131,1.3392857142857142,0,0.0,8.375031397
Ba,56,76,132,1.3571428571428572,0,1.0,8.384960045
Ba,56,77,133,1.375,0,0.0,8.37961097
Ba,56,78,134,1.3928571428571428,0,1.0,8.388164246
Ba,56,79,135,1.4107142857142858,0,0.0,8.380607548
Ba,56,80,136,1.4285714285714286,0,1.0,8.386441985
Ba,56,81,137,1.4464285714285714,0,0.0,8.375525358
Ba,56,82,138,1.4642857142857142,1,1.0,8.381533797
Ba,56,83,139,1.4821428571428572,0,0.0,8.34906841
Ba,56,84,140,1.5,0,1.0,8.332424443
Ba,56,85,141,1.5178571428571428,0,0.0,8.303814887
Ba,56,86,142,1.5357142857142858,0,1.0,8.286177423
Ba,56,87,143,1.5535714285714286,0,0.0,8.256109678
Ba,56,88,144,1.5714285714285714,0,1.0,8.237736583
Ba,56,89,145,1.5892857142857142,0,0.0,8.204358014
Ba,56,90,146,1.6071428571428572,0,1.0,8.18310887
Ba,56,91,147,1.625,0,0.0,8.148520075
Ba,56,92,148,1.6428571428571428,0,1.0,8.125901595
Ba,56,93,149,1.6607142857142858,0,0.0,8.092227604
Ba,56,94,150,1.6785714285714286,0,1.0,8.07035854
Ba,56,95,151,1.6964285714285714,0,0.0,8.035918053
Ba,56,96,152,1.7142857142857142,0,1.0,8.013109849
Ba,56,97,153,1.7321428571428572,0,0.0,7.978310412
Ba,56,98,154,1.75,0,1.0,7.954999201
Ba,56,99,155,1.7678571428571428,0,0.0,7.919555852
Ba,56,100,156,1.7857142857142858,0,1.0,7.895579782
Ba,56,101,157,1.8035714285714286,0,0.0,7.858443599
Ba,56,102,158,1.8214285714285714,0,1.0,7.832736873
Ba,56,103,159,1.8392857142857142,0,0.0,7.793337201
Ba,56,104,160,1.8571428571428572,0,1.0,7.765189519
Ba,56,105,161,1.875,0,0.0,7.724225149
Ba,56,106,162,1.8928571428571428,0,1.0,7.694179883
Ba,56,107,163,1.9107142857142858,0,0.0,7.653450374
Ba,56,108,164,1.9285714285714286,0,1.0,7.623363652
Ba,56,109,165,1.9464285714285714,0,0.0,7.583366485
Ba,56,110,166,1.9642857142857142,0,1.0,7.553891422
Ba,56,111,167,1.9821428571428572,0,0.0,7.514191228
Ba,56,112,168,2.0,0,1.0,7.484974988
Ba,56,113,169,2.017857142857143,0,0.0,7.444056675
Ba,56,114,170,2.0357142857142856,0,1.0,7.413583441
Ba,56,115,171,2.0535714285714284,0,0.0,7.371230959
Ba,56,116,172,2.0714285714285716,0,1.0,7.338885599
Ba,56,117,173,2.0892857142857144,0,0.0,7.298009838
Ba,56,118,174,2.107142857142857,0,1.0,7.266676684
Ba,56,119,175,2.125,0,0.0,7.228207891
Ba,56,120,176,2.142857142857143,0,1.0,7.199123455
Ba,56,121,177,2.1607142857142856,0,0.0,7.162340757
Ba,56,122,178,2.1785714285714284,0,1.0,7.13482382
Ba,56,123,179,2.1964285714285716,0,0.0,7.10050224
Ba,56,124,180,2.2142857142857144,0,1.0,7.07581425
Ba,56,125,181,2.232142857142857,0,0.0,7.039745392
Ba,56,126,182,2.25,1,1.0,7.01544344
La,57,60,117,1.0526315789473684,0,0.0,8.077269214
La,57,61,118,1.0701754385964912,0,-1.0,8.104444712
La,57,62,119,1.087719298245614,0,0.0,8.147785059
La,57,63,120,1.105263157894737,0,-1.0,8.16799665
La,57,64,121,1.1228070175438596,0,0.0,8.203638248
La,57,65,122,1.1403508771929824,0,-1.0,8.219659803
La,57,66,123,1.1578947368421053,0,0.0,8.251105951
La,57,67,124,1.1754385964912282,0,-1.0,8.262720685
La,57,68,125,1.1929824561403508,0,0.0,8.289961136
La,57,69,126,1.2105263157894737,0,-1.0,8.295665524
La,57,70,127,1.2280701754385965,0,0.0,8.316859276
La,57,71,128,1.2456140350877194,0,-1.0,8.317587141
La,57,72,129,1.263157894736842,0,0.0,8.333355519
La,57,73,130,1.280701754385965,0,-1.0,8.331725385
La,57,74,131,1.2982456140350878,0,0.0,8.344688023
La,57,75,132,1.3157894736842106,0,-1.0,8.342834803
La,57,76,133,1.3333333333333333,0,0.0,8.355058684
La,57,77,134,1.3508771929824561,0,-1.0,8.352446545
La,57,78,135,1.368421052631579,0,0.0,8.363396452
La,57,79,136,1.3859649122807018,0,-1.0,8.358226471
La,57,80,137,1.4035087719298245,0,0.0,8.366226307
La,57,81,138,1.4210526315789473,0,-1.0,8.357448478
La,57,82,139,1.4385964912280702,1,0.0,8.365465604
La,57,83,140,1.456140350877193,0,-1.0,8.335654507
La,57,84,141,1.4736842105263157,0,0.0,8.321511837
La,57,85,142,1.4912280701754386,0,-1.0,8.295518915
La,57,86,143,1.5087719298245614,0,0.0,8.280348902
La,57,87,144,1.5263157894736843,0,-1.0,8.253101438
La,57,88,145,1.543859649122807,0,0.0,8.237426083
La,57,89,146,1.5614035087719298,0,-1.0,8.20758437
La,57,90,147,1.5789473684210527,0,0.0,8.189645075
La,57,91,148,1.5964912280701755,0,-1.0,8.160099858
La,57,92,149,1.6140350877192982,0,0.0,8.142258242
La,57,93,150,1.631578947368421,0,-1.0,8.1116572
La,57,94,151,1.6491228070175439,0,0.0,8.092642722
La,57,95,152,1.6666666666666667,0,-1.0,8.060454921
La,57,96,153,1.6842105263157894,0,0.0,8.039591627
La,57,97,154,1.7017543859649122,0,-1.0,8.006874948
La,57,98,155,1.719298245614035,0,0.0,7.985316832
La,57,99,156,1.736842105263158,0,-1.0,7.951731301
La,57,100,157,1.7543859649122806,0,0.0,7.929367096
La,57,101,158,1.7719298245614035,0,-1.0,7.893761532
La,57,102,159,1.7894736842105263,0,0.0,7.86937717
La,57,103,160,1.8070175438596492,0,-1.0,7.8313432
La,57,104,161,1.8245614035087718,0,0.0,7.804382441
La,57,105,162,1.8421052631578947,0,-1.0,7.764445938
La,57,106,163,1.8596491228070176,0,0.0,7.735296877
La,57,107,164,1.8771929824561404,0,-1.0,7.69564836
La,57,108,165,1.894736842105263,0,0.0,7.666481158
La,57,109,166,1.912280701754386,0,-1.0,7.628091307
La,57,110,167,1.9298245614035088,0,0.0,7.600021407
La,57,111,168,1.9473684210526316,0,-1.0,7.562065411
La,57,112,169,1.9649122807017543,0,0.0,7.534389994
La,57,113,170,1.9824561403508771,0,-1.0,7.495123024
La,57,114,171,2.0,0,0.0,7.466148421
La,57,115,172,2.017543859649123,0,-1.0,7.425141459
La,57,116,173,2.0350877192982457,0,0.0,7.393982543
La,57,117,174,2.0526315789473686,0,-1.0,7.354174276
La,57,118,175,2.0701754385964914,0,0.0,7.32366136
La,57,119,176,2.087719298245614,0,-1.0,7.286083205
La,57,120,177,2.1052631578947367,0,0.0,7.257601678
La,57,121,178,2.1228070175438596,0,-1.0,7.221573843
La,57,122,179,2.1403508771929824,0,0.0,7.194648665
La,57,123,180,2.1578947368421053,0,-1.0,7.161646256
La,57,124,181,2.175438596491228,0,0.0,7.138241343
La,57,125,182,2.192982456140351,0,-1.0,7.103338286
La,57,126,183,2.210526315789474,1,0.0,7.080204197
Ce,58,60,118,1.0344827586206897,0,1.0,8.022764424
Ce,58,61,119,1.0517241379310345,0,0.0,8.053168983
Ce,58,62,120,1.0689655172413792,0,1.0,8.099634225
Ce,58,63,121,1.0862068965517242,0,0.0,8.122952669
Ce,58,64,122,1.103448275862069,0,1.0,8.161342811
Ce,58,65,123,1.1206896551724137,0,0.0,8.179725228
Ce,58,66,124,1.1379310344827587,0,1.0,8.213163137
Ce,58,67,125,1.1551724137931034,0,0.0,8.227092392
Ce,58,68,126,1.1724137931034482,0,1.0,8.256305667
Ce,58,69,127,1.1896551724137931,0,0.0,8.264195669
Ce,58,70,128,1.206896551724138,0,1.0,8.287273344
Ce,58,71,129,1.2241379310344827,0,0.0,8.290080256
Ce,58,72,130,1.2413793103448276,0,1.0,8.3076082
Ce,58,73,131,1.2586206896551724,0,0.0,8.308348786
Ce,58,74,132,1.2758620689655173,0,1.0,8.323322553
Ce,58,75,133,1.293103448275862,0,0.0,8.32408882
Ce,58,76,134,1.3103448275862069,0,1.0,8.338547246
Ce,58,77,135,1.3275862068965518,0,0.0,8.338688874
Ce,58,78,136,1.3448275862068966,0,1.0,8.352056993
Ce,58,79,137,1.3620689655172413,0,0.0,8.349571533
Ce,58,80,138,1.3793103448275863,0,1.0,8.360033449
Ce,58,81,139,1.396551724137931,0,0.0,8.35372436
Ce,58,82,140,1.4137931034482758,1,1.0,8.364077264
Ce,58,83,141,1.4310344827586208,0,0.0,8.336083539
Ce,58,84,142,1.4482758620689655,0,1.0,8.323619211
Ce,58,85,143,1.4655172413793103,0,0.0,8.299689266
Ce,58,86,144,1.4827586206896552,0,1.0,8.286442799
Ce,58,87,145,1.5,0,0.0,8.261630359
Ce,58,88,146,1.5172413793103448,0,1.0,8.248274445
Ce,58,89,147,1.5344827586206897,0,0.0,8.22162734
Ce,58,90,148,1.5517241379310345,0,1.0,8.206663358
Ce,58,91,149,1.5689655172413792,0,0.0,8.181731007
Ce,58,92,150,1.5862068965517242,0,1.0,8.168244847
Ce,58,93,151,1.603448275862069,0,0.0,8.140482662
Ce,58,94,152,1.6206896551724137,0,1.0,8.124094645
Ce,58,95,153,1.6379310344827587,0,0.0,8.09412615
Ce,58,96,154,1.6551724137931034,0,1.0,8.075178825
Ce,58,97,155,1.6724137931034482,0,0.0,8.044515484
Ce,58,98,156,1.6896551724137931,0,1.0,8.02468566
Ce,58,99,157,1.706896551724138,0,0.0,7.992860777
Ce,58,100,158,1.7241379310344827,0,1.0,7.972015595
Ce,58,101,159,1.7413793103448276,0,0.0,7.937830566
Ce,58,102,160,1.7586206896551724,0,1.0,7.914662456
Ce,58,103,161,1.7758620689655173,0,0.0,7.877919311
Ce,58,104,162,1.793103448275862,0,1.0,7.852073716
Ce,58,105,163,1.8103448275862069,0,0.0,7.81313516
Ce,58,106,164,1.8275862068965518,0,1.0,7.78485436
Ce,58,107,165,1.8448275862068966,0,0.0,7.746258448
Ce,58,108,166,1.8620689655172413,0,1.0,7.717984675
Ce,58,109,167,1.8793103448275863,0,0.0,7.68115679
Ce,58,110,168,1.896551724137931,0,1.0,7.654449661
Ce,58,111,169,1.9137931034482758,0,0.0,7.61815926
Ce,58,112,170,1.9310344827586208,0,1.0,7.591949371
Ce,58,113,171,1.9482758620689655,0,0.0,7.554220158
Ce,58,114,172,1.9655172413793103,0,1.0,7.526633674
Ce,58,115,173,1.9827586206896552,0,0.0,7.486820422
Ce,58,116,174,2.0,0,1.0,7.456699695
Ce,58,117,175,2.0172413793103448,0,0.0,7.417866629
Ce,58,118,176,2.0344827586206895,0,1.0,7.388085517
Ce,58,119,177,2.0517241379310347,0,0.0,7.351421107
Ce,58,120,178,2.0689655172413794,0,1.0,7.323568551
Ce,58,121,179,2.086206896551724,0,0.0,7.28842367
Ce,58,122,180,2.103448275862069,0,1.0,7.262218733
Ce,58,123,181,2.1206896551724137,0,0.0,7.23064432
Ce,58,124,182,2.1379310344827585,0,1.0,7.208630527
Ce,58,125,183,2.1551724137931036,0,0.0,7.174800503
Ce,58,126,184,2.1724137931034484,1,1.0,7.1527425
Pr,59,60,119,1.0169491525423728,0,0.0,7.944260756
Pr,59,62,121,1.0508474576271187,0,0.0,8.028092132
Pr,59,64,123,1.0847457627118644,0,0.0,8.096116642
Pr,59,65,124,1.1016949152542372,0,-1.0,8.117497855
Pr,59,66,125,1.11864406779661,0,0.0,8.153655408
Pr,59,67,126,1.1355932203389831,0,-1.0,8.170356333
Pr,59,68,127,1.152542372881356,0,0.0,8.201973173
Pr,59,69,128,1.1694915254237288,0,-1.0,8.213004938
Pr,59,70,129,1.1864406779661016,0,0.0,8.238828752
Pr,59,71,130,1.2033898305084745,0,-1.0,8.244901046
Pr,59,72,131,1.2203389830508475,0,0.0,8.265554672
Pr,59,73,132,1.2372881355932204,0,-1.0,8.266935121
Pr,59,74,133,1.2542372881355932,0,0.0,8.282737511
Pr,59,75,134,1.271186440677966,0,-1.0,8.285216276
Pr,59,76,135,1.2881355932203389,0,0.0,8.301351281
Pr,59,77,136,1.305084745762712,0,-1.0,8.304122574
Pr,59,78,137,1.3220338983050848,0,0.0,8.31982038
Pr,59,79,138,1.3389830508474576,0,-1.0,8.31997371
Pr,59,80,139,1.3559322033898304,0,0.0,8.332851863
Pr,59,81,140,1.3728813559322033,0,-1.0,8.329451414
Pr,59,82,141,1.3898305084745763,1,0.0,8.342545901
Pr,59,83,142,1.4067796610169492,0,-1.0,8.316657725
Pr,59,84,143,1.423728813559322,0,0.0,8.306179853
Pr,59,85,144,1.4406779661016949,0,-1.0,8.284384326
Pr,59,86,145,1.4576271186440677,0,0.0,8.273167586
Pr,59,87,146,1.4745762711864407,0,-1.0,8.251270932
Pr,59,88,147,1.4915254237288136,0,0.0,8.240697415
Pr,59,89,148,1.5084745762711864,0,-1.0,8.218289318
Pr,59,90,149,1.5254237288135593,0,0.0,8.207521396
Pr,59,91,150,1.5423728813559323,0,-1.0,8.18585784
Pr,59,92,151,1.5593220338983051,0,0.0,8.175698278
Pr,59,93,152,1.576271186440678,0,-1.0,8.150552842
Pr,59,94,153,1.5932203389830508,0,0.0,8.136745967
Pr,59,95,154,1.6101694915254237,0,-1.0,8.109116831
Pr,59,96,155,1.6271186440677967,0,0.0,8.092388168
Pr,59,97,156,1.6440677966101696,0,-1.0,8.063802795
Pr,59,98,157,1.6610169491525424,0,0.0,8.045906809
Pr,59,99,158,1.6779661016949152,0,-1.0,8.015972278
Pr,59,100,159,1.694915254237288,0,0.0,7.996869107
Pr,59,101,160,1.7118644067796611,0,-1.0,7.964387981
Pr,59,102,161,1.728813559322034,0,0.0,7.942731217
Pr,59,103,162,1.7457627118644068,0,-1.0,7.907860809
Pr,59,104,163,1.7627118644067796,0,0.0,7.883617908
Pr,59,105,164,1.7796610169491525,0,-1.0,7.84695353
Pr,59,106,165,1.7966101694915255,0,0.0,7.820836224
Pr,59,107,166,1.8135593220338984,0,-1.0,7.782070524
Pr,59,108,167,1.8305084745762712,0,0.0,7.753662228
Pr,59,109,168,1.847457627118644,0,-1.0,7.718364786
Pr,59,110,169,1.8644067796610169,0,0.0,7.693071367
Pr,59,111,170,1.88135593220339,0,-1.0,7.658271865
Pr,59,112,171,1.8983050847457628,0,0.0,7.633378649
Pr,59,113,172,1.9152542372881356,0,-1.0,7.597071895
Pr,59,114,173,1.9322033898305084,0,0.0,7.57074489
Pr,59,115,174,1.9491525423728813,0,-1.0,7.532268184
Pr,59,116,175,1.9661016949152543,0,0.0,7.503332029
Pr,59,117,176,1.9830508474576272,0,-1.0,7.465540761
Pr,59,118,177,2.0,0,0.0,7.436629356
Pr,59,119,178,2.016949152542373,0,-1.0,7.400891702
Pr,59,120,179,2.0338983050847457,0,0.0,7.37378495
Pr,59,121,180,2.0508474576271185,0,-1.0,7.340262722
Pr,59,122,181,2.0677966101694913,0,0.0,7.315553884
Pr,59,123,182,2.0847457627118646,0,-1.0,7.284937374
Pr,59,124,183,2.1016949152542375,0,0.0,7.263784104
Pr,59,125,184,2.1186440677966103,0,-1.0,7.231148462
Pr,59,126,185,2.135593220338983,1,0.0,7.210211795
Nd,60,61,121,1.0166666666666666,0,0.0,7.919229521
Nd,60,62,122,1.0333333333333334,0,1.0,7.972102008
Nd,60,63,123,1.05,0,0.0,8.001747967
Nd,60,64,124,1.0666666666666667,0,1.0,8.045928508
Nd,60,65,125,1.0833333333333333,0,0.0,8.07008084
Nd,60,66,126,1.1,0,1.0,8.108738389
Nd,60,67,127,1.1166666666666667,0,0.0,8.127987543
Nd,60,68,128,1.1333333333333333,0,1.0,8.16179375
Nd,60,69,129,1.15,0,0.0,8.175707496
Nd,60,70,130,1.1666666666666667,0,1.0,8.204027746
Nd,60,71,131,1.1833333333333333,0,0.0,8.213124122
Nd,60,72,132,1.2,0,1.0,8.236667886
Nd,60,73,133,1.2166666666666666,0,0.0,8.238679444
Nd,60,74,134,1.2333333333333334,0,1.0,8.25529903
Nd,60,75,135,1.25,0,0.0,8.259682541
Nd,60,76,136,1.2666666666666666,0,1.0,8.277684103
Nd,60,77,137,1.2833333333333334,0,0.0,8.28322135
Nd,60,78,138,1.3,0,1.0,8.301387493
Nd,60,79,139,1.3166666666666667,0,0.0,8.304403878
Nd,60,80,140,1.3333333333333333,0,1.0,8.3199225
Nd,60,81,141,1.35,0,0.0,8.319671411
Nd,60,82,142,1.3666666666666667,1,1.0,8.335747169
Nd,60,83,143,1.3833333333333333,0,0.0,8.311317371
Nd,60,84,144,1.4,0,1.0,8.302189417
Nd,60,85,145,1.4166666666666667,0,0.0,8.281950248
Nd,60,86,146,1.4333333333333333,0,1.0,8.272194514
Nd,60,87,147,1.45,0,0.0,8.252663646
Nd,60,88,148,1.4666666666666666,0,1.0,8.24433175
Nd,60,89,149,1.4833333333333334,0,0.0,8.225720148
Nd,60,90,150,1.5,0,1.0,8.21871224
Nd,60,91,151,1.5166666666666666,0,0.0,8.200242066
Nd,60,92,152,1.5333333333333334,0,1.0,8.193333921
Nd,60,93,153,1.55,0,0.0,8.170709444
Nd,60,94,154,1.5666666666666667,0,1.0,8.159389656
Nd,60,95,155,1.5833333333333333,0,0.0,8.133992748
Nd,60,96,156,1.6,0,1.0,8.119378564
Nd,60,97,157,1.6166666666666667,0,0.0,8.092736236
Nd,60,98,158,1.6333333333333333,0,1.0,8.076642709
Nd,60,99,159,1.65,0,0.0,8.048416811
Nd,60,100,160,1.6666666666666667,0,1.0,8.03087805
Nd,60,101,161,1.6833333333333333,0,0.0,7.999928839
Nd,60,102,162,1.7,0,1.0,7.979615932
Nd,60,103,163,1.7166666666666666,0,0.0,7.946507699
Nd,60,104,164,1.7333333333333334,0,1.0,7.923761579
Nd,60,105,165,1.75,0,0.0,7.889258782
Nd,60,106,166,1.7666666666666666,0,1.0,7.86519506
Nd,60,107,167,1.7833333333333334,0,0.0,7.826063856
Nd,60,108,168,1.8,0,1.0,7.797327232
Nd,60,109,169,1.8166666666666667,0,0.0,7.763518047
Nd,60,110,170,1.8333333333333333,0,1.0,7.739598018
Nd,60,111,171,1.85,0,0.0,7.706236819
Nd,60,112,172,1.8666666666666667,0,1.0,7.68261032
Nd,60,113,173,1.8833333333333333,0,0.0,7.647690254
Nd,60,114,174,1.9,0,1.0,7.622589236
Nd,60,115,175,1.9166666666666667,0,0.0,7.585433417
Nd,60,116,176,1.9333333333333333,0,1.0,7.557668091
Nd,60,117,177,1.95,0,0.0,7.520942237
Nd,60,118,178,1.9666666666666666,0,1.0,7.492925831
Nd,60,119,179,1.9833333333333334,0,0.0,7.45813995
Nd,60,120,180,2.0,0,1.0,7.431805744
Nd,60,121,181,2.0166666666666666,0,0.0,7.399967381
Nd,60,122,182,2.033333333333333,0,1.0,7.376816566
Nd,60,123,183,2.05,0,0.0,7.347142049
Nd,60,124,184,2.066666666666667,0,1.0,7.326834625
Nd,60,125,185,2.0833333333333335,0,0.0,7.295313741
Nd,60,126,186,2.1,1,1.0,7.275420425
Pm,61,64,125,1.0491803278688525,0,0.0,7.96979868
Pm,61,66,127,1.0819672131147542,0,0.0,8.039783551
Pm,61,68,129,1.1147540983606556,0,0.0,8.099763527
Pm,61,69,130,1.1311475409836065,0,-1.0,8.116974323
Pm,61,70,131,1.1475409836065573,0,0.0,8.148328282
Pm,61,71,132,1.1639344262295082,0,-1.0,8.160394894
Pm,61,72,133,1.180327868852459,0,0.0,8.186663774
Pm,61,73,134,1.1967213114754098,0,-1.0,8.191538097
Pm,61,74,135,1.2131147540983607,0,0.0,8.210782793
Pm,61,75,136,1.2295081967213115,0,-1.0,8.215821228
Pm,61,76,137,1.2459016393442623,0,0.0,8.234233109
Pm,61,77,138,1.2622950819672132,0,-1.0,8.241846935
Pm,61,78,139,1.278688524590164,0,0.0,8.26181554
Pm,61,79,140,1.2950819672131149,0,-1.0,8.26787725
Pm,61,80,141,1.3114754098360655,0,0.0,8.286232106
Pm,61,81,142,1.3278688524590163,0,-1.0,8.28944281
Pm,61,82,143,1.3442622950819672,1,0.0,8.308802517
Pm,61,83,144,1.360655737704918,0,-1.0,8.286330611
Pm,61,84,145,1.3770491803278688,0,0.0,8.279081717
Pm,61,85,146,1.3934426229508197,0,-1.0,8.260697726
Pm,61,86,147,1.4098360655737705,0,0.0,8.25273515
Pm,61,87,148,1.4262295081967213,0,-1.0,8.236381149
Pm,61,88,149,1.4426229508196722,0,0.0,8.231094027
Pm,61,89,150,1.459016393442623,0,-1.0,8.21505126
Pm,61,90,151,1.4754098360655739,0,0.0,8.210531642
Pm,61,91,152,1.4918032786885247,0,-1.0,8.193970928
Pm,61,92,153,1.5081967213114753,0,0.0,8.188883647
Pm,61,93,154,1.5245901639344261,0,-1.0,8.16855661
Pm,61,94,155,1.540983606557377,0,0.0,8.159421839
Pm,61,95,156,1.5573770491803278,0,-1.0,8.136461929
Pm,61,96,157,1.5737704918032787,0,0.0,8.124209917
Pm,61,97,158,1.5901639344262295,0,-1.0,8.099962538
Pm,61,98,159,1.6065573770491803,0,0.0,8.086184371
Pm,61,99,160,1.6229508196721312,0,-1.0,8.060285063
Pm,61,100,161,1.639344262295082,0,0.0,8.044960646
Pm,61,101,162,1.6557377049180328,0,-1.0,8.016185599
Pm,61,102,163,1.6721311475409837,0,0.0,7.997923571
Pm,61,103,164,1.6885245901639345,0,-1.0,7.966680963
Pm,61,104,165,1.7049180327868851,0,0.0,7.945690097
Pm,61,105,166,1.721311475409836,0,-1.0,7.912774452
Pm,61,106,167,1.7377049180327868,0,0.0,7.890147389
Pm,61,107,168,1.7540983606557377,0,-1.0,7.853737506
Pm,61,108,169,1.7704918032786885,0,0.0,7.82757332
Pm,61,109,170,1.7868852459016393,0,-1.0,7.794865553
Pm,61,110,171,1.8032786885245902,0,0.0,7.771936064
Pm,61,111,172,1.819672131147541,0,-1.0,7.739781552
Pm,61,112,173,1.8360655737704918,0,0.0,7.717229052
Pm,61,113,174,1.8524590163934427,0,-1.0,7.683334632
Pm,61,114,175,1.8688524590163935,0,0.0,7.659142086
Pm,61,115,176,1.8852459016393444,0,-1.0,7.622968432
Pm,61,116,177,1.901639344262295,0,0.0,7.596100915
Pm,61,117,178,1.9180327868852458,0,-1.0,7.560323236
Pm,61,118,179,1.9344262295081966,0,0.0,7.533395564
Pm,61,119,180,1.9508196721311475,0,-1.0,7.499991878
Pm,61,120,181,1.9672131147540983,0,0.0,7.47522763
Pm,61,121,182,1.9836065573770492,0,-1.0,7.444755231
Pm,61,122,183,2.0,0,0.0,7.422934486
Pm,61,123,184,2.0163934426229506,0,-1.0,7.394286842
Pm,61,124,185,2.0327868852459017,0,0.0,7.374894319
Pm,61,125,186,2.0491803278688523,0,-1.0,7.344552188
Pm,61,126,187,2.0655737704918034,1,0.0,7.325758925
Pm,61,140,201,2.2950819672131146,0,0.0,6.786540861
Sm,62,65,127,1.0483870967741935,0,0.0,7.939503346
Sm,62,66,128,1.064516129032258,0,1.0,7.984822344
Sm,62,67,129,1.0806451612903225,0,0.0,8.011082271
Sm,62,68,130,1.096774193548387,0,1.0,8.051342585
Sm,62,69,131,1.1129032258064515,0,0.0,8.071623725
Sm,62,70,132,1.1290322580645162,0,1.0,8.105792129
Sm,62,71,133,1.1451612903225807,0,0.0,8.120610805
Sm,62,72,134,1.1612903225806452,0,1.0,8.149393552
Sm,62,73,135,1.1774193548387097,0,0.0,8.157000007
Sm,62,74,136,1.1935483870967742,0,1.0,8.178744588
Sm,62,75,137,1.2096774193548387,0,0.0,8.185000241
Sm,62,76,138,1.2258064516129032,0,1.0,8.20438013
Sm,62,77,139,1.2419354838709677,0,0.0,8.214283338
Sm,62,78,140,1.2580645161290323,0,1.0,8.236268079
Sm,62,79,141,1.2741935483870968,0,0.0,8.245619752
Sm,62,80,142,1.2903225806451613,0,1.0,8.267054986
Sm,62,81,143,1.3064516129032258,0,0.0,8.273728573
Sm,62,82,144,1.3225806451612903,1,1.0,8.296375778
Sm,62,83,145,1.3387096774193548,0,0.0,8.275439717
Sm,62,84,146,1.3548387096774193,0,1.0,8.269654671
Sm,62,85,147,1.3709677419354838,0,0.0,8.252597163
Sm,62,86,148,1.3870967741935485,0,1.0,8.245907014
Sm,62,87,149,1.403225806451613,0,0.0,8.232106899
Sm,62,88,150,1.4193548387096775,0,1.0,8.229251647
Sm,62,89,151,1.435483870967742,0,0.0,8.215118046
Sm,62,90,152,1.4516129032258065,0,1.0,8.212436776
Sm,62,91,153,1.467741935483871,0,0.0,8.197667281
Sm,62,92,154,1.4838709677419355,0,1.0,8.194285299
Sm,62,93,155,1.5,0,0.0,8.176134413
Sm,62,94,156,1.5161290322580645,0,1.0,8.169066372
Sm,62,95,157,1.532258064516129,0,0.0,8.14839751
Sm,62,96,158,1.5483870967741935,0,1.0,8.138364519
Sm,62,97,159,1.564516129032258,0,0.0,8.116358465
Sm,62,98,160,1.5806451612903225,0,1.0,8.104744944
Sm,62,99,161,1.596774193548387,0,0.0,8.081022957
Sm,62,100,162,1.6129032258064515,0,1.0,8.067766846
Sm,62,101,163,1.6290322580645162,0,0.0,8.041034546
Sm,62,102,164,1.6451612903225807,0,1.0,8.024695073
Sm,62,103,165,1.6612903225806452,0,0.0,7.995228491
Sm,62,104,166,1.6774193548387097,0,1.0,7.975905687
Sm,62,105,167,1.6935483870967742,0,0.0,7.944478754
Sm,62,106,168,1.7096774193548387,0,1.0,7.923192875
Sm,62,107,169,1.7258064516129032,0,0.0,7.889308462
Sm,62,108,170,1.7419354838709677,0,1.0,7.865524906
Sm,62,109,171,1.7580645161290323,0,0.0,7.834029789
Sm,62,110,172,1.7741935483870968,0,1.0,7.812202064
Sm,62,111,173,1.7903225806451613,0,0.0,7.78115837
Sm,62,112,174,1.8064516129032258,0,1.0,7.759586615
Sm,62,113,175,1.8225806451612903,0,0.0,7.726647634
Sm,62,114,176,1.8387096774193548,0,1.0,7.703295483
Sm,62,115,177,1.8548387096774193,0,0.0,7.668104644
Sm,62,116,178,1.8709677419354838,0,1.0,7.642136539
Sm,62,117,179,1.8870967741935485,0,0.0,7.607486659
Sm,62,118,180,1.903225806451613,0,1.0,7.581823789
Sm,62,119,181,1.9193548387096775,0,0.0,7.549808271
Sm,62,120,182,1.935483870967742,0,1.0,7.52661783
Sm,62,121,183,1.9516129032258065,0,0.0,7.49752182
Sm,62,122,184,1.967741935483871,0,1.0,7.477041859
Sm,62,123,185,1.9838709677419355,0,0.0,7.449326973
Sm,62,124,186,2.0,0,1.0,7.430757457
Sm,62,125,187,2.0161290322580645,0,0.0,7.401494369
Sm,62,126,188,2.032258064516129,1,1.0,7.383703335
Sm,62,138,200,2.225806451612903,0,1.0,6.92344441
Sm,62,140,202,2.2580645161290325,0,1.0,6.856859891
Sm,62,142,204,2.2903225806451615,0,1.0,6.790143912
Eu,63,68,131,1.0793650793650793,0,0.0,7.984212053
Eu,63,70,133,1.1111111111111112,0,0.0,8.044876774
Eu,63,71,134,1.126984126984127,0,-1.0,8.062335948
Eu,63,72,135,1.1428571428571428,0,0.0,8.093528215
Eu,63,73,136,1.1587301587301588,0,-1.0,8.103862551
Eu,63,74,137,1.1746031746031746,0,0.0,8.128021869
Eu,63,75,138,1.1904761904761905,0,-1.0,8.136255188
Eu,63,76,139,1.2063492063492063,0,0.0,8.157474719
Eu,63,77,140,1.2222222222222223,0,-1.0,8.169931607
Eu,63,78,141,1.2380952380952381,0,0.0,8.194428851
Eu,63,79,142,1.253968253968254,0,-1.0,8.205568444
Eu,63,80,143,1.2698412698412698,0,0.0,8.228686378
Eu,63,81,144,1.2857142857142858,0,-1.0,8.237967264
Eu,63,82,145,1.3015873015873016,1,0.0,8.263073048
Eu,63,83,146,1.3174603174603174,0,-1.0,8.244442438
Eu,63,84,147,1.3333333333333333,0,0.0,8.24086149
Eu,63,85,148,1.3492063492063493,0,-1.0,8.22578725
Eu,63,86,149,1.3650793650793651,0,0.0,8.220996879
Eu,63,87,150,1.380952380952381,0,-1.0,8.210161233
Eu,63,88,151,1.3968253968253967,0,0.0,8.210157689
Eu,63,89,152,1.4126984126984128,0,-1.0,8.198305533
Eu,63,90,153,1.4285714285714286,0,0.0,8.197797026
Eu,63,91,154,1.4444444444444444,0,-1.0,8.185056065
Eu,63,92,155,1.4603174603174602,0,0.0,8.183571187
Eu,63,93,156,1.4761904761904763,0,-1.0,8.167697532
Eu,63,94,157,1.492063492063492,0,0.0,8.162816191
Eu,63,95,158,1.507936507936508,0,-1.0,8.144492114
Eu,63,96,159,1.5238095238095237,0,0.0,8.136753371
Eu,63,97,160,1.5396825396825398,0,-1.0,8.117068819
Eu,63,98,161,1.5555555555555556,0,0.0,8.107724267
Eu,63,99,162,1.5714285714285714,0,-1.0,8.086243457
Eu,63,100,163,1.5873015873015872,0,0.0,8.075142736
Eu,63,101,164,1.6031746031746033,0,-1.0,8.050612665
Eu,63,102,165,1.619047619047619,0,0.0,8.036381812
Eu,63,103,166,1.6349206349206349,0,-1.0,8.008897012
Eu,63,104,167,1.6507936507936507,0,0.0,7.99151885
Eu,63,105,168,1.6666666666666667,0,-1.0,7.961607202
Eu,63,106,169,1.6825396825396826,0,0.0,7.941672527
Eu,63,107,170,1.6984126984126984,0,-1.0,7.910365076
Eu,63,108,171,1.7142857142857142,0,0.0,7.888785719
Eu,63,109,172,1.7301587301587302,0,-1.0,7.858956238
Eu,63,110,173,1.746031746031746,0,0.0,7.838539428
Eu,63,111,174,1.7619047619047619,0,-1.0,7.808667391
Eu,63,112,175,1.7777777777777777,0,0.0,7.788173851
Eu,63,113,176,1.7936507936507937,0,-1.0,7.756185074
Eu,63,114,177,1.8095238095238095,0,0.0,7.733672294
Eu,63,115,178,1.8253968253968254,0,-1.0,7.699438062
Eu,63,116,179,1.8412698412698412,0,0.0,7.674347777
Eu,63,117,180,1.8571428571428572,0,-1.0,7.642013489
Eu,63,118,181,1.873015873015873,0,0.0,7.618626403
Eu,63,119,182,1.8888888888888888,0,-1.0,7.587491077
Eu,63,120,183,1.9047619047619047,0,0.0,7.565084344
Eu,63,121,184,1.9206349206349207,0,-1.0,7.536426065
Eu,63,122,185,1.9365079365079365,0,0.0,7.516224535
Eu,63,123,186,1.9523809523809523,0,-1.0,7.489376167
Eu,63,124,187,1.9682539682539681,0,0.0,7.471527476
Eu,63,125,188,1.9841269841269842,0,-1.0,7.443491521
Eu,63,126,189,2.0,1,0.0,7.426839074
Eu,63,138,201,2.1904761904761907,0,0.0,6.979186498
Eu,63,140,203,2.2222222222222223,0,0.0,6.914235039
Eu,63,142,205,2.253968253968254,0,0.0,6.849397839
Eu,63,144,207,2.2857142857142856,0,0.0,6.783991227
Gd,64,68,132,1.0625,0,1.0,7.930039606
Gd,64,69,133,1.078125,0,0.0,7.956525143
Gd,64,70,134,1.09375,0,1.0,7.996590948
Gd,64,71,135,1.109375,0,0.0,8.016476378
Gd,64,72,136,1.125,0,1.0,8.049870485
Gd,64,73,137,1.140625,0,0.0,8.062742226
Gd,64,74,138,1.15625,0,1.0,8.089133116
Gd,64,75,139,1.171875,0,0.0,8.100242604
Gd,64,76,140,1.1875,0,1.0,8.124189414
Gd,64,77,141,1.203125,0,0.0,8.139307518
Gd,64,78,142,1.21875,0,1.0,8.166423873
Gd,64,79,143,1.234375,0,0.0,8.179741035
Gd,64,80,144,1.25,0,1.0,8.204927361
Gd,64,81,145,1.265625,0,0.0,8.216638262
Gd,64,82,146,1.28125,1,1.0,8.244029808
Gd,64,83,147,1.296875,0,0.0,8.227453184
Gd,64,84,148,1.3125,0,1.0,8.225829649
Gd,64,85,149,1.328125,0,0.0,8.212254785
Gd,64,86,150,1.34375,0,1.0,8.208887847
Gd,64,87,151,1.359375,0,0.0,8.200343093
Gd,64,88,152,1.375,0,1.0,8.202528039
Gd,64,89,153,1.390625,0,0.0,8.192185346
Gd,64,90,154,1.40625,0,1.0,8.193089045
Gd,64,91,155,1.421875,0,0.0,8.182004897
Gd,64,92,156,1.4375,0,1.0,8.182051853
Gd,64,93,157,1.453125,0,0.0,8.168262115
Gd,64,94,158,1.46875,0,1.0,8.165377772
Gd,64,95,159,1.484375,0,0.0,8.149238805
Gd,64,96,160,1.5,0,1.0,8.14363725
Gd,64,97,161,1.515625,0,0.0,8.126151298
Gd,64,98,162,1.53125,0,1.0,8.118954988
Gd,64,99,163,1.546875,0,0.0,8.099628656
Gd,64,100,164,1.5625,0,1.0,8.090598756
Gd,64,101,165,1.578125,0,0.0,8.068197745
Gd,64,102,166,1.59375,0,1.0,8.056004355
Gd,64,103,167,1.609375,0,0.0,8.030431192
Gd,64,104,168,1.625,0,1.0,8.014928792
Gd,64,105,169,1.640625,0,0.0,7.986486704
Gd,64,106,170,1.65625,0,1.0,7.967859971
Gd,64,107,171,1.671875,0,0.0,7.939116784
Gd,64,108,172,1.6875,0,1.0,7.919733413
Gd,64,109,173,1.703125,0,0.0,7.891670486
Gd,64,110,174,1.71875,0,1.0,7.872767287
Gd,64,111,175,1.734375,0,0.0,7.843962177
Gd,64,112,176,1.75,0,1.0,7.824444369
Gd,64,113,177,1.765625,0,0.0,7.793318153
Gd,64,114,178,1.78125,0,1.0,7.771559348
Gd,64,115,179,1.796875,0,0.0,7.738264642
Gd,64,116,180,1.8125,0,1.0,7.714036172
Gd,64,117,181,1.828125,0,0.0,7.684214983
Gd,64,118,182,1.84375,0,1.0,7.663299434
Gd,64,119,183,1.859375,0,0.0,7.633037153
Gd,64,120,184,1.875,0,1.0,7.611408109
Gd,64,121,185,1.890625,0,0.0,7.583257876
Gd,64,122,186,1.90625,0,1.0,7.563406048
Gd,64,123,187,1.921875,0,0.0,7.537427005
Gd,64,124,188,1.9375,0,1.0,7.520303463
Gd,64,125,189,1.953125,0,0.0,7.493388577
Gd,64,126,190,1.96875,1,1.0,7.477770711
Gd,64,128,192,2.0,0,1.0,7.401638307
Gd,64,136,200,2.125,0,1.0,7.105096035
Gd,64,138,202,2.15625,0,1.0,7.041168723
Gd,64,140,204,2.1875,0,1.0,6.977579662
Gd,64,142,206,2.21875,0,1.0,6.914398223
Gd,64,144,208,2.25,0,1.0,6.850826394
Tb,65,70,135,1.0769230769230769,0,0.0,7.931502859
Tb,65,72,137,1.1076923076923078,0,0.0,7.98913165
Tb,65,73,138,1.123076923076923,0,-1.0,8.004696
Tb,65,74,139,1.1384615384615384,0,0.0,8.03342336
Tb,65,75,140,1.1538461538461537,0,-1.0,8.047216779
Tb,65,76,141,1.1692307692307693,0,0.0,8.073566688
Tb,65,77,142,1.1846153846153846,0,-1.0,8.090989803
Tb,65,78,143,1.2,0,0.0,8.120214972
Tb,65,79,144,1.2153846153846153,0,-1.0,8.13416816
Tb,65,80,145,1.2307692307692308,0,0.0,8.159864234
Tb,65,81,146,1.2461538461538462,0,-1.0,8.174019705
Tb,65,82,147,1.2615384615384615,1,0.0,8.203697054
Tb,65,83,148,1.2769230769230768,0,-1.0,8.189643973
Tb,65,84,149,1.2923076923076924,0,0.0,8.190424329
Tb,65,85,150,1.3076923076923077,0,-1.0,8.17969232
Tb,65,86,151,1.323076923076923,0,0.0,8.17925143
Tb,65,87,152,1.3384615384615384,0,-1.0,8.172861921
Tb,65,88,153,1.353846153846154,0,0.0,8.177261176
Tb,65,89,154,1.3692307692307693,0,-1.0,8.16919989
Tb,65,90,155,1.3846153846153846,0,0.0,8.172255471
Tb,65,91,156,1.4,0,-1.0,8.163211064
Tb,65,92,157,1.4153846153846155,0,0.0,8.16518786
Tb,65,93,158,1.4307692307692308,0,-1.0,8.153610722
Tb,65,94,159,1.4461538461538461,0,0.0,8.152874535
Tb,65,95,160,1.4615384615384615,0,-1.0,8.139036888
Tb,65,96,161,1.476923076923077,0,0.0,8.135712093
Tb,65,97,162,1.4923076923076923,0,-1.0,8.120478611
Tb,65,98,163,1.5076923076923077,0,0.0,8.115508454
Tb,65,99,164,1.523076923076923,0,-1.0,8.098359646
Tb,65,100,165,1.5384615384615385,0,0.0,8.091435285
Tb,65,101,166,1.5538461538461539,0,-1.0,8.071225687
Tb,65,102,167,1.5692307692307692,0,0.0,8.06111476
Tb,65,103,168,1.5846153846153845,0,-1.0,8.037692964
Tb,65,104,169,1.6,0,0.0,8.024212006
Tb,65,105,170,1.6153846153846154,0,-1.0,7.997890688
Tb,65,106,171,1.6307692307692307,0,0.0,7.981219749
Tb,65,107,172,1.646153846153846,0,-1.0,7.954377808
Tb,65,108,173,1.6615384615384616,0,0.0,7.936710324
Tb,65,109,174,1.676923076923077,0,-1.0,7.910337937
Tb,65,110,175,1.6923076923076923,0,0.0,7.892956726
Tb,65,111,176,1.7076923076923076,0,-1.0,7.865566943
Tb,65,112,177,1.7230769230769232,0,0.0,7.847364288
Tb,65,113,178,1.7384615384615385,0,-1.0,7.817299028
Tb,65,114,179,1.7538461538461538,0,0.0,7.796479514
Tb,65,115,180,1.7692307692307692,0,-1.0,7.764263206
Tb,65,116,181,1.7846153846153847,0,0.0,7.741096188
Tb,65,117,182,1.8,0,-1.0,7.713098962
Tb,65,118,183,1.8153846153846154,0,0.0,7.694031071
Tb,65,119,184,1.8307692307692307,0,-1.0,7.664839353
Tb,65,120,185,1.8461538461538463,0,0.0,7.644222362
Tb,65,121,186,1.8615384615384616,0,-1.0,7.616271613
Tb,65,122,187,1.876923076923077,0,0.0,7.596520428
Tb,65,123,188,1.8923076923076922,0,-1.0,7.570882293
Tb,65,124,189,1.9076923076923078,0,0.0,7.553976704
Tb,65,125,190,1.9230769230769231,0,-1.0,7.528244053
Tb,65,126,191,1.9384615384615385,1,0.0,7.513753257
Tb,65,128,193,1.9692307692307693,0,0.0,7.439779389
Tb,65,130,195,2.0,0,0.0,7.364502369
Tb,65,132,197,2.0307692307692307,0,0.0,7.291529
Tb,65,134,199,2.0615384615384613,0,0.0,7.220794497
Tb,65,136,201,2.0923076923076924,0,0.0,7.153455264
Tb,65,137,202,2.1076923076923078,0,-1.0,7.118377525
Tb,65,138,203,2.123076923076923,0,0.0,7.090900463
Tb,65,140,205,2.1538461538461537,0,0.0,7.028892746
Tb,65,142,207,2.1846153846153844,0,0.0,6.967402333
Tb,65,144,209,2.2153846153846155,0,0.0,6.905683249
Tb,65,146,211,2.246153846153846,0,0.0,6.842173863
Dy,66,71,137,1.0757575757575757,0,0.0,7.903117569
Dy,66,72,138,1.0909090909090908,0,1.0,7.940467754
Dy,66,73,139,1.106060606060606,0,0.0,7.958551928
Dy,66,74,140,1.121212121212121,0,1.0,7.989450507
Dy,66,75,141,1.1363636363636365,0,0.0,8.006749135
Dy,66,76,142,1.1515151515151516,0,1.0,8.036315789
Dy,66,77,143,1.1666666666666667,0,0.0,8.056045811
Dy,66,78,144,1.1818181818181819,0,1.0,8.087384396
Dy,66,79,145,1.196969696969697,0,0.0,8.102487034
Dy,66,80,146,1.2121212121212122,0,1.0,8.129200993
Dy,66,81,147,1.2272727272727273,0,0.0,8.145584952
Dy,66,82,148,1.2424242424242424,1,1.0,8.177337108
Dy,66,83,149,1.2575757575757576,0,0.0,8.165616443
Dy,66,84,150,1.2727272727272727,0,1.0,8.168613713
Dy,66,85,151,1.2878787878787878,0,0.0,8.160186411
Dy,66,86,152,1.303030303030303,0,1.0,8.162139395
Dy,66,87,153,1.3181818181818181,0,0.0,8.157317026
Dy,66,88,154,1.3333333333333333,0,1.0,8.163349357
Dy,66,89,155,1.3484848484848484,0,0.0,8.157006703
Dy,66,90,156,1.3636363636363635,0,1.0,8.161660269
Dy,66,91,157,1.378787878787879,0,0.0,8.154364624
Dy,66,92,158,1.393939393939394,0,1.0,8.157985361
Dy,66,93,159,1.4090909090909092,0,0.0,8.148450258
Dy,66,94,160,1.4242424242424243,0,1.0,8.149694619
Dy,66,95,161,1.4393939393939394,0,0.0,8.137974416
Dy,66,96,162,1.4545454545454546,0,1.0,8.136745086
Dy,66,97,163,1.4696969696969697,0,0.0,8.123595779
Dy,66,98,164,1.4848484848484849,0,1.0,8.12068586
Dy,66,99,165,1.5,0,0.0,8.105567891
Dy,66,100,166,1.5151515151515151,0,1.0,8.100605024
Dy,66,101,167,1.5303030303030303,0,0.0,8.082472593
Dy,66,102,168,1.5454545454545454,0,1.0,8.074332554
Dy,66,103,169,1.5606060606060606,0,0.0,8.05297713
Dy,66,104,170,1.5757575757575757,0,1.0,8.041435147
Dy,66,105,171,1.5909090909090908,0,0.0,8.017196918
Dy,66,106,172,1.606060606060606,0,1.0,8.002446459
Dy,66,107,173,1.621212121212121,0,0.0,7.977489191
Dy,66,108,174,1.6363636363636365,0,1.0,7.961523345
Dy,66,109,175,1.6515151515151516,0,0.0,7.936769349
Dy,66,110,176,1.6666666666666667,0,1.0,7.920840722
Dy,66,111,177,1.6818181818181819,0,0.0,7.894771181
Dy,66,112,178,1.696969696969697,0,1.0,7.877790787
Dy,66,113,179,1.7121212121212122,0,0.0,7.848720961
Dy,66,114,180,1.7272727272727273,0,1.0,7.8287773
Dy,66,115,181,1.7424242424242424,0,0.0,7.797739569
Dy,66,116,182,1.7575757575757576,0,1.0,7.775733258
Dy,66,117,183,1.7727272727272727,0,0.0,7.749598574
Dy,66,118,184,1.7878787878787878,0,1.0,7.732416234
Dy,66,119,185,1.803030303030303,0,0.0,7.704295173
Dy,66,120,186,1.8181818181818181,0,1.0,7.684690962
Dy,66,121,187,1.8333333333333333,0,0.0,7.657096631
Dy,66,122,188,1.8484848484848484,0,1.0,7.637602394
Dy,66,123,189,1.8636363636363635,0,0.0,7.612461429
Dy,66,124,190,1.878787878787879,0,1.0,7.595929695
Dy,66,125,191,1.893939393939394,0,0.0,7.571278319
Dy,66,126,192,1.9090909090909092,1,1.0,7.557815271
Dy,66,128,194,1.9393939393939394,0,1.0,7.485812778
Dy,66,130,196,1.9696969696969697,0,1.0,7.41241276
Dy,66,132,198,2.0,0,1.0,7.34153151
Dy,66,134,200,2.0303030303030303,0,1.0,7.273854045
Dy,66,136,202,2.0606060606060606,0,1.0,7.208527144
Dy,66,137,203,2.0757575757575757,0,0.0,7.173914704
Dy,66,138,204,2.090909090909091,0,1.0,7.1468525
Dy,66,139,205,2.106060606060606,0,0.0,7.11268179
Dy,66,140,206,2.121212121212121,0,1.0,7.086132723
Dy,66,141,207,2.1363636363636362,0,0.0,7.052288874
Dy,66,142,208,2.1515151515151514,0,1.0,7.026141976
Dy,66,144,210,2.1818181818181817,0,1.0,6.966149257
Dy,66,146,212,2.212121212121212,0,1.0,6.904483075
Dy,66,148,214,2.242424242424242,0,1.0,6.840664734
Ho,67,72,139,1.0746268656716418,0,0.0,7.874470187
Ho,67,74,141,1.1044776119402986,0,0.0,7.928113986
Ho,67,76,143,1.1343283582089552,0,0.0,7.980140357
Ho,67,77,144,1.1492537313432836,0,-1.0,8.002140146
Ho,67,78,145,1.164179104477612,0,0.0,8.035549897
Ho,67,79,146,1.1791044776119404,0,-1.0,8.051520171
Ho,67,80,147,1.1940298507462686,0,0.0,8.078929014
Ho,67,81,148,1.208955223880597,0,-1.0,8.097584358
Ho,67,82,149,1.2238805970149254,1,0.0,8.13142849
Ho,67,83,150,1.2388059701492538,0,-1.0,8.122496893
Ho,67,84,151,1.2537313432835822,0,0.0,8.12818653
Ho,67,85,152,1.2686567164179106,0,-1.0,8.122976967
Ho,67,86,153,1.2835820895522387,0,0.0,8.127868745
Ho,67,87,154,1.2985074626865671,0,-1.0,8.125057773
Ho,67,88,155,1.3134328358208955,0,0.0,8.132733394
Ho,67,89,156,1.328358208955224,0,-1.0,8.128196615
Ho,67,90,157,1.3432835820895523,0,0.0,8.13444765
Ho,67,91,158,1.3582089552238805,0,-1.0,8.128769095
Ho,67,92,159,1.373134328358209,0,0.0,8.133860673
Ho,67,93,160,1.3880597014925373,0,-1.0,8.126376606
Ho,67,94,161,1.4029850746268657,0,0.0,8.12960377
Ho,67,95,162,1.4179104477611941,0,-1.0,8.120124321
Ho,67,96,163,1.4328358208955223,0,0.0,8.121128
Ho,67,97,164,1.4477611940298507,0,-1.0,8.11022111
Ho,67,98,165,1.462686567164179,0,0.0,8.109551727
Ho,67,99,166,1.4776119402985075,0,-1.0,8.096623572
Ho,67,100,167,1.492537313432836,0,0.0,8.093806838
Ho,67,101,168,1.507462686567164,0,-1.0,8.077888375
Ho,67,102,169,1.5223880597014925,0,0.0,8.071864663
Ho,67,103,170,1.537313432835821,0,-1.0,8.052756788
Ho,67,104,171,1.5522388059701493,0,0.0,8.043318795
Ho,67,105,172,1.5671641791044777,0,-1.0,8.021335407
Ho,67,106,173,1.5820895522388059,0,0.0,8.008666572
Ho,67,107,174,1.5970149253731343,0,-1.0,7.985817793
Ho,67,108,175,1.6119402985074627,0,0.0,7.971777589
Ho,67,109,176,1.626865671641791,0,-1.0,7.948955153
Ho,67,110,177,1.6417910447761195,0,0.0,7.934783853
Ho,67,111,178,1.6567164179104477,0,-1.0,7.910371848
Ho,67,112,179,1.671641791044776,0,0.0,7.894953665
Ho,67,113,180,1.6865671641791045,0,-1.0,7.867073372
Ho,67,114,181,1.7014925373134329,0,0.0,7.848210856
Ho,67,115,182,1.7164179104477613,0,-1.0,7.818377599
Ho,67,116,183,1.7313432835820894,0,0.0,7.797407279
Ho,67,117,184,1.7462686567164178,0,-1.0,7.772631158
Ho,67,118,185,1.7611940298507462,0,0.0,7.756683886
Ho,67,119,186,1.7761194029850746,0,-1.0,7.729696124
Ho,67,120,187,1.791044776119403,0,0.0,7.711174401
Ho,67,121,188,1.8059701492537314,0,-1.0,7.684126309
Ho,67,122,189,1.8208955223880596,0,0.0,7.665108529
Ho,67,123,190,1.835820895522388,0,-1.0,7.640594353
Ho,67,124,191,1.8507462686567164,0,0.0,7.624381654
Ho,67,125,192,1.8656716417910448,0,-1.0,7.600669844
Ho,67,126,193,1.8805970149253732,1,0.0,7.587880902
Ho,67,128,195,1.9104477611940298,0,0.0,7.518035154
Ho,67,130,197,1.9402985074626866,0,0.0,7.447213244
Ho,67,131,198,1.955223880597015,0,-1.0,7.409762879
Ho,67,132,199,1.9701492537313432,0,0.0,7.37954805
Ho,67,133,200,1.9850746268656716,0,-1.0,7.343215335
Ho,67,134,201,2.0,0,0.0,7.314400025
Ho,67,135,202,2.014925373134328,0,-1.0,7.278962619
Ho,67,136,203,2.029850746268657,0,0.0,7.251050946
Ho,67,137,204,2.044776119402985,0,-1.0,7.217257814
Ho,67,138,205,2.0597014925373136,0,0.0,7.190985585
Ho,67,139,206,2.074626865671642,0,-1.0,7.157677563
Ho,67,140,207,2.08955223880597,0,0.0,7.131935377
Ho,67,141,208,2.1044776119402986,0,-1.0,7.098877144
Ho,67,142,209,2.1194029850746268,0,0.0,7.073434627
Ho,67,143,210,2.1343283582089554,0,-1.0,7.04029831
Ho,67,144,211,2.1492537313432836,0,0.0,7.014855346
Ho,67,146,213,2.1791044776119404,0,0.0,6.954783723
Ho,67,148,215,2.208955223880597,0,0.0,6.892725935
Ho,67,150,217,2.2388059701492535,0,0.0,6.829615217
Er,68,73,141,1.0735294117647058,0,0.0,7.84351517
Er,68,74,142,1.088235294117647,0,1.0,7.878591
Er,68,75,143,1.1029411764705883,0,0.0,7.901828874
Er,68,76,144,1.1176470588235294,0,1.0,7.936824132
Er,68,77,145,1.1323529411764706,0,0.0,7.961084931
Er,68,78,146,1.1470588235294117,0,1.0,7.996559932
Er,68,79,147,1.161764705882353,0,0.0,8.014056633
Er,68,80,148,1.1764705882352942,0,1.0,8.042812601
Er,68,81,149,1.1911764705882353,0,0.0,8.063566201
Er,68,82,150,1.2058823529411764,1,1.0,8.09933388
Er,68,83,151,1.2205882352941178,0,0.0,8.092912013
Er,68,84,152,1.2352941176470589,0,1.0,8.101019612
Er,68,85,153,1.25,0,0.0,8.098508941
Er,68,86,154,1.2647058823529411,0,1.0,8.105831032
Er,68,87,155,1.2794117647058822,0,0.0,8.104491284
Er,68,88,156,1.2941176470588236,0,1.0,8.113281667
Er,68,89,157,1.3088235294117647,0,0.0,8.11008914
Er,68,90,158,1.3235294117647058,0,1.0,8.117484519
Er,68,91,159,1.338235294117647,0,0.0,8.113200503
Er,68,92,160,1.3529411764705883,0,1.0,8.119544994
Er,68,93,161,1.3676470588235294,0,0.0,8.113975727
Er,68,94,162,1.3823529411764706,0,1.0,8.119052006
Er,68,95,163,1.3970588235294117,0,0.0,8.111642485
Er,68,96,164,1.411764705882353,0,1.0,8.114710524
Er,68,97,165,1.4264705882352942,0,0.0,8.105861527
Er,68,98,166,1.4411764705882353,0,1.0,8.10725041
Er,68,99,167,1.4558823529411764,0,0.0,8.096329012
Er,68,100,168,1.4705882352941178,0,1.0,8.095478054
Er,68,101,169,1.4852941176470589,0,0.0,8.081620805
Er,68,102,170,1.5,0,1.0,8.077563624
Er,68,103,171,1.5147058823529411,0,0.0,8.060577187
Er,68,104,172,1.5294117647058822,0,1.0,8.053120215
Er,68,105,173,1.5441176470588236,0,0.0,8.033306179
Er,68,106,174,1.5588235294117647,0,1.0,8.022636437
Er,68,107,175,1.5735294117647058,0,0.0,8.001836634
Er,68,108,176,1.588235294117647,0,1.0,7.989665295
Er,68,109,177,1.6029411764705883,0,0.0,7.968709667
Er,68,110,178,1.6176470588235294,0,1.0,7.95623364
Er,68,111,179,1.6323529411764706,0,0.0,7.933410296
Er,68,112,180,1.6470588235294117,0,1.0,7.919487272
Er,68,113,181,1.661764705882353,0,0.0,7.892753282
Er,68,114,182,1.6764705882352942,0,1.0,7.874930346
Er,68,115,183,1.6911764705882353,0,0.0,7.846479262
Er,68,116,184,1.7058823529411764,0,1.0,7.826722522
Er,68,117,185,1.7205882352941178,0,0.0,7.803240076
Er,68,118,186,1.7352941176470589,0,1.0,7.788465011
Er,68,119,187,1.75,0,0.0,7.762603369
Er,68,120,188,1.7647058823529411,0,1.0,7.745157574
Er,68,121,189,1.7794117647058822,0,0.0,7.718843788
Er,68,122,190,1.7941176470588236,0,1.0,7.700489289
Er,68,123,191,1.8088235294117647,0,0.0,7.676835958
Er,68,124,192,1.8235294117647058,0,1.0,7.661177104
Er,68,125,193,1.838235294117647,0,0.0,7.638371808
Er,68,126,194,1.8529411764705883,1,1.0,7.626227
Er,68,127,195,1.8676470588235294,0,0.0,7.587382554
Er,68,128,196,1.8823529411764706,0,1.0,7.558343281
Er,68,129,197,1.8970588235294117,0,0.0,7.520746853
Er,68,130,198,1.911764705882353,0,1.0,7.489855955
Er,68,131,199,1.9264705882352942,0,0.0,7.453812749
Er,68,132,200,1.9411764705882353,0,1.0,7.42492043
Er,68,133,201,1.9558823529411764,0,0.0,7.389701299
Er,68,134,202,1.9705882352941178,0,1.0,7.361899272
Er,68,135,203,1.9852941176470589,0,0.0,7.327268936
Er,68,136,204,2.0,0,1.0,7.300131652
Er,68,137,205,2.014705882352941,0,0.0,7.26697402
Er,68,138,206,2.0294117647058822,0,1.0,7.241310029
Er,68,139,207,2.0441176470588234,0,0.0,7.208757541
Er,68,140,208,2.0588235294117645,0,1.0,7.183716639
Er,68,141,209,2.073529411764706,0,0.0,7.151362627
Er,68,142,210,2.088235294117647,0,1.0,7.126544643
Er,68,143,211,2.1029411764705883,0,0.0,7.094093507
Er,68,144,212,2.1176470588235294,0,1.0,7.06923692
Er,68,145,213,2.1323529411764706,0,0.0,7.036118822
Er,68,146,214,2.1470588235294117,0,1.0,7.010607192
Er,68,148,216,2.176470588235294,0,1.0,6.950158634
Er,68,150,218,2.2058823529411766,0,1.0,6.888786349
Er,68,152,220,2.235294117647059,0,1.0,6.827723227
Er,68,154,222,2.264705882352941,0,1.0,6.767129401
Tm,69,76,145,1.1014492753623188,0,0.0,7.87427451
Tm,69,78,147,1.1304347826086956,0,0.0,7.93895398
Tm,69,80,149,1.1594202898550725,0,0.0,7.989115792
Tm,69,81,150,1.173913043478261,0,-1.0,8.011832833
Tm,69,82,151,1.1884057971014492,1,0.0,8.049399523
Tm,69,83,152,1.2028985507246377,0,-1.0,8.045664257
Tm,69,84,153,1.2173913043478262,0,0.0,8.056312
Tm,69,85,154,1.2318840579710144,0,-1.0,8.056892195
Tm,69,86,155,1.2463768115942029,0,0.0,8.06716811
Tm,69,87,156,1.2608695652173914,0,-1.0,8.067884372
Tm,69,88,157,1.2753623188405796,0,0.0,8.078578955
Tm,69,89,158,1.289855072463768,0,-1.0,8.076996405
Tm,69,90,159,1.3043478260869565,0,0.0,8.085824742
Tm,69,91,160,1.318840579710145,0,-1.0,8.082842894
Tm,69,92,161,1.3333333333333333,0,0.0,8.090310863
Tm,69,93,162,1.3478260869565217,0,-1.0,8.086354093
Tm,69,94,163,1.3623188405797102,0,0.0,8.092900258
Tm,69,95,164,1.3768115942028984,0,-1.0,8.087482701
Tm,69,96,165,1.391304347826087,0,0.0,8.092471721
Tm,69,97,166,1.4057971014492754,0,-1.0,8.085694855
Tm,69,98,167,1.4202898550724639,0,0.0,8.08910121
Tm,69,99,168,1.434782608695652,0,-1.0,8.08026303
Tm,69,100,169,1.4492753623188406,0,0.0,8.081409533
Tm,69,101,170,1.463768115942029,0,-1.0,8.069629024
Tm,69,102,171,1.4782608695652173,0,0.0,8.06754324
Tm,69,103,172,1.4927536231884058,0,-1.0,8.052674826
Tm,69,104,173,1.5072463768115942,0,0.0,8.047213549
Tm,69,105,174,1.5217391304347827,0,-1.0,8.029596305
Tm,69,106,175,1.536231884057971,0,0.0,8.021002737
Tm,69,107,176,1.5507246376811594,0,-1.0,8.002272443
Tm,69,108,177,1.565217391304348,0,0.0,7.992056446
Tm,69,109,178,1.5797101449275361,0,-1.0,7.973012388
Tm,69,110,179,1.5942028985507246,0,0.0,7.962314274
Tm,69,111,180,1.608695652173913,0,-1.0,7.941232861
Tm,69,112,181,1.6231884057971016,0,0.0,7.928944099
Tm,69,113,182,1.6376811594202898,0,-1.0,7.90365672
Tm,69,114,183,1.6521739130434783,0,0.0,7.887190093
Tm,69,115,184,1.6666666666666667,0,-1.0,7.859966989
Tm,69,116,185,1.681159420289855,0,0.0,7.841305086
Tm,69,117,186,1.6956521739130435,0,-1.0,7.819131172
Tm,69,118,187,1.710144927536232,0,0.0,7.805525888
Tm,69,119,188,1.7246376811594204,0,-1.0,7.780948941
Tm,69,120,189,1.7391304347826086,0,0.0,7.764671196
Tm,69,121,190,1.7536231884057971,0,-1.0,7.739670342
Tm,69,122,191,1.7681159420289856,0,0.0,7.722525471
Tm,69,123,192,1.7826086956521738,0,-1.0,7.699861172
Tm,69,124,193,1.7971014492753623,0,0.0,7.685145865
Tm,69,125,194,1.8115942028985508,0,-1.0,7.662945557
Tm,69,126,195,1.826086956521739,1,0.0,7.651380836
Tm,69,127,196,1.8405797101449275,0,-1.0,7.61364852
Tm,69,128,197,1.855072463768116,0,0.0,7.585693944
Tm,69,129,198,1.8695652173913044,0,-1.0,7.549397293
Tm,69,130,199,1.8840579710144927,0,0.0,7.519814342
Tm,69,131,200,1.8985507246376812,0,-1.0,7.485269395
Tm,69,132,201,1.9130434782608696,0,0.0,7.457865299
Tm,69,133,202,1.9275362318840579,0,-1.0,7.423820401
Tm,69,134,203,1.9420289855072463,0,0.0,7.397168995
Tm,69,135,204,1.9565217391304348,0,-1.0,7.363487892
Tm,69,136,205,1.9710144927536233,0,0.0,7.337296829
Tm,69,137,206,1.9855072463768115,0,-1.0,7.304898684
Tm,69,138,207,2.0,0,0.0,7.279998551
Tm,69,139,208,2.0144927536231885,0,-1.0,7.248221851
Tm,69,140,209,2.028985507246377,0,0.0,7.223943344
Tm,69,141,210,2.0434782608695654,0,-1.0,7.192352867
Tm,69,142,211,2.0579710144927534,0,0.0,7.168252711
Tm,69,143,212,2.072463768115942,0,-1.0,7.136604519
Tm,69,144,213,2.0869565217391304,0,0.0,7.112475427
Tm,69,145,214,2.101449275362319,0,-1.0,7.080247449
Tm,69,146,215,2.1159420289855073,0,0.0,7.055549693
Tm,69,148,217,2.1449275362318843,0,0.0,6.996905152
Tm,69,150,219,2.1739130434782608,0,0.0,6.937353311
Tm,69,152,221,2.2028985507246377,0,0.0,6.878042977
Tm,69,154,223,2.2318840579710146,0,0.0,6.8191913
Tm,69,156,225,2.260869565217391,0,0.0,6.760395564
Yb,70,77,147,1.1,0,0.0,7.853387027
Yb,70,78,148,1.1142857142857143,0,1.0,7.893593547
Yb,70,79,149,1.1285714285714286,0,0.0,7.916050919
Yb,70,80,150,1.1428571428571428,0,1.0,7.949369593
Yb,70,81,151,1.1571428571428573,0,0.0,7.973985132
Yb,70,82,152,1.1714285714285715,1,1.0,8.013288908
Yb,70,83,153,1.1857142857142857,0,0.0,8.011809392
Yb,70,84,154,1.2,0,1.0,8.024573929
Yb,70,85,155,1.2142857142857142,0,0.0,8.027747632
Yb,70,86,156,1.2285714285714286,0,1.0,8.040488141
Yb,70,87,157,1.2428571428571429,0,0.0,8.042736134
Yb,70,88,158,1.2571428571428571,0,1.0,8.054819184
Yb,70,89,159,1.2714285714285714,0,0.0,8.054393157
Yb,70,90,160,1.2857142857142858,0,1.0,8.064208869
Yb,70,91,161,1.3,0,0.0,8.062246298
Yb,70,92,162,1.3142857142857143,0,1.0,8.070560549
Yb,70,93,163,1.3285714285714285,0,0.0,8.068087356
Yb,70,94,164,1.3428571428571427,0,1.0,8.075977805
Yb,70,95,165,1.3571428571428572,0,0.0,8.072481848
Yb,70,96,166,1.3714285714285714,0,1.0,8.079323199
Yb,70,97,167,1.3857142857142857,0,0.0,8.074523701
Yb,70,98,168,1.4,0,1.0,8.079854548
Yb,70,99,169,1.4142857142857144,0,0.0,8.073001402
Yb,70,100,170,1.4285714285714286,0,1.0,8.076049341
Yb,70,101,171,1.4428571428571428,0,0.0,8.066284146
Yb,70,102,172,1.457142857142857,0,1.0,8.066110285
Yb,70,103,173,1.4714285714285715,0,0.0,8.05331089
Yb,70,104,174,1.4857142857142858,0,1.0,8.049798282
Yb,70,105,175,1.5,0,0.0,8.034301343
Yb,70,106,176,1.5142857142857142,0,1.0,8.02770971
Yb,70,107,177,1.5285714285714285,0,0.0,8.010961407
Yb,70,108,178,1.542857142857143,0,1.0,8.002615494
Yb,70,109,179,1.5571428571428572,0,0.0,7.985392821
Yb,70,110,180,1.5714285714285714,0,1.0,7.976384928
Yb,70,111,181,1.5857142857142856,0,0.0,7.956928436
Yb,70,112,182,1.6,0,1.0,7.946159418
Yb,70,113,183,1.6142857142857143,0,0.0,7.922167596
Yb,70,114,184,1.6285714285714286,0,1.0,7.906908848
Yb,70,115,185,1.6428571428571428,0,0.0,7.880875465
Yb,70,116,186,1.6571428571428573,0,1.0,7.863271984
Yb,70,117,187,1.6714285714285715,0,0.0,7.842350059
Yb,70,118,188,1.6857142857142857,0,1.0,7.829860096
Yb,70,119,189,1.7,0,0.0,7.806551545
Yb,70,120,190,1.7142857142857142,0,1.0,7.791426968
Yb,70,121,191,1.7285714285714286,0,0.0,7.767975859
Yb,70,122,192,1.7428571428571429,0,1.0,7.752276026
Yb,70,123,193,1.7571428571428571,0,0.0,7.730878808
Yb,70,124,194,1.7714285714285714,0,1.0,7.717382701
Yb,70,125,195,1.7857142857142858,0,0.0,7.695886462
Yb,70,126,196,1.8,1,1.0,7.685000163
Yb,70,127,197,1.8142857142857143,0,0.0,7.648283543
Yb,70,128,198,1.8285714285714285,0,1.0,7.621318475
Yb,70,129,199,1.8428571428571427,0,0.0,7.586121995
Yb,70,130,200,1.8571428571428572,0,1.0,7.557649305
Yb,70,131,201,1.8714285714285714,0,0.0,7.524255259
Yb,70,132,202,1.8857142857142857,0,1.0,7.497995574
Yb,70,133,203,1.9,0,0.0,7.464896291
Yb,70,134,204,1.9142857142857144,0,1.0,7.439169348
Yb,70,135,205,1.9285714285714286,0,0.0,7.406246868
Yb,70,136,206,1.9428571428571428,0,1.0,7.380813296
Yb,70,137,207,1.957142857142857,0,0.0,7.349045314
Yb,70,138,208,1.9714285714285715,0,1.0,7.324780918
Yb,70,139,209,1.9857142857142858,0,0.0,7.293714478
Yb,70,140,210,2.0,0,1.0,7.270133595
Yb,70,141,211,2.0142857142857142,0,0.0,7.239246502
Yb,70,142,212,2.0285714285714285,0,1.0,7.215805019
Yb,70,143,213,2.0428571428571427,0,0.0,7.184878488
Yb,70,144,214,2.057142857142857,0,1.0,7.161397075
Yb,70,145,215,2.0714285714285716,0,0.0,7.129965656
Yb,70,146,216,2.085714285714286,0,1.0,7.105989778
Yb,70,147,217,2.1,0,0.0,7.073801
Yb,70,148,218,2.1142857142857143,0,1.0,7.048959156
Yb,70,150,220,2.142857142857143,0,1.0,6.991063423
Yb,70,152,222,2.1714285714285713,0,1.0,6.933406311
Yb,70,154,224,2.2,0,1.0,6.876242893
Yb,70,156,226,2.2285714285714286,0,1.0,6.819249146
Yb,70,158,228,2.257142857142857,0,1.0,6.760286421
Lu,71,80,151,1.1267605633802817,0,0.0,7.892666152
Lu,71,82,153,1.1549295774647887,1,0.0,7.959963882
Lu,71,83,154,1.1690140845070423,0,-1.0,7.960970916
Lu,71,84,155,1.1830985915492958,0,0.0,7.976087555
Lu,71,85,156,1.1971830985915493,0,-1.0,7.981898814
Lu,71,86,157,1.2112676056338028,0,0.0,7.99715458
Lu,71,87,158,1.2253521126760563,0,-1.0,8.001636949
Lu,71,88,159,1.2394366197183098,0,0.0,8.015832145
Lu,71,89,160,1.2535211267605635,0,-1.0,8.017271431
Lu,71,90,161,1.267605633802817,0,0.0,8.028856242
Lu,71,91,162,1.2816901408450705,0,-1.0,8.028361296
Lu,71,92,163,1.295774647887324,0,0.0,8.038073288
Lu,71,93,164,1.3098591549295775,0,-1.0,8.036806262
Lu,71,94,165,1.323943661971831,0,0.0,8.045810927
Lu,71,95,166,1.3380281690140845,0,-1.0,8.043543289
Lu,71,96,167,1.352112676056338,0,0.0,8.051491737
Lu,71,97,168,1.3661971830985915,0,-1.0,8.048171423
Lu,71,98,169,1.380281690140845,0,0.0,8.054831657
Lu,71,99,170,1.3943661971830985,0,-1.0,8.049681235
Lu,71,100,171,1.408450704225352,0,0.0,8.054280743
Lu,71,101,172,1.4225352112676057,0,-1.0,8.045964297
Lu,71,102,173,1.4366197183098592,0,0.0,8.047113064
Lu,71,103,174,1.4507042253521127,0,-1.0,8.03579427
Lu,71,104,175,1.4647887323943662,0,0.0,8.033648366
Lu,71,105,176,1.4788732394366197,0,-1.0,8.020175153
Lu,71,106,177,1.4929577464788732,0,0.0,8.015551864
Lu,71,107,178,1.5070422535211268,0,-1.0,8.000764612
Lu,71,108,179,1.5211267605633803,0,0.0,7.994363302
Lu,71,109,180,1.5352112676056338,0,-1.0,7.978974367
Lu,71,110,181,1.5492957746478873,0,0.0,7.971731735
Lu,71,111,182,1.5633802816901408,0,-1.0,7.954243082
Lu,71,112,183,1.5774647887323943,0,0.0,7.945267202
Lu,71,113,184,1.591549295774648,0,-1.0,7.923671957
Lu,71,114,185,1.6056338028169015,0,0.0,7.910625973
Lu,71,115,186,1.619718309859155,0,-1.0,7.887074054
Lu,71,116,187,1.6338028169014085,0,0.0,7.871783968
Lu,71,117,188,1.647887323943662,0,-1.0,7.851844676
Lu,71,118,189,1.6619718309859155,0,0.0,7.840171561
Lu,71,119,190,1.676056338028169,0,-1.0,7.818443605
Lu,71,120,191,1.6901408450704225,0,0.0,7.804712932
Lu,71,121,192,1.704225352112676,0,-1.0,7.783230385
Lu,71,122,193,1.7183098591549295,0,0.0,7.769341135
Lu,71,123,194,1.732394366197183,0,-1.0,7.749087026
Lu,71,124,195,1.7464788732394365,0,0.0,7.736731738
Lu,71,125,196,1.7605633802816902,0,-1.0,7.715905464
Lu,71,126,197,1.7746478873239437,1,0.0,7.705694284
Lu,71,127,198,1.7887323943661972,0,-1.0,7.670107475
Lu,71,128,199,1.8028169014084507,0,0.0,7.644244648
Lu,71,129,200,1.8169014084507042,0,-1.0,7.610223205
Lu,71,130,201,1.8309859154929577,0,0.0,7.582931786
Lu,71,131,202,1.8450704225352113,0,-1.0,7.550759847
Lu,71,132,203,1.8591549295774648,0,0.0,7.525710493
Lu,71,133,204,1.8732394366197183,0,-1.0,7.493758515
Lu,71,134,205,1.8873239436619718,0,0.0,7.469160888
Lu,71,135,206,1.9014084507042253,0,-1.0,7.437229345
Lu,71,136,207,1.9154929577464788,0,0.0,7.41279186
Lu,71,137,208,1.9295774647887325,0,-1.0,7.381738899
Lu,71,138,209,1.943661971830986,0,0.0,7.358212689
Lu,71,139,210,1.9577464788732395,0,-1.0,7.327839214
Lu,71,140,211,1.971830985915493,0,0.0,7.304962479
Lu,71,141,212,1.9859154929577465,0,-1.0,7.274843972
Lu,71,142,213,2.0,0,0.0,7.252151939
Lu,71,143,214,2.0140845070422535,0,-1.0,7.222083449
Lu,71,144,215,2.028169014084507,0,0.0,7.199405916
Lu,71,145,216,2.0422535211267605,0,-1.0,7.168918759
Lu,71,146,217,2.056338028169014,0,0.0,7.145815309
Lu,71,147,218,2.0704225352112675,0,-1.0,7.114564936
Lu,71,148,219,2.084507042253521,0,0.0,7.090596443
Lu,71,149,220,2.0985915492957745,0,-1.0,7.058937323
Lu,71,150,221,2.112676056338028,0,0.0,7.034359303
Lu,71,151,222,2.1267605633802815,0,-1.0,7.002805748
Lu,71,152,223,2.140845070422535,0,0.0,6.978139601
Lu,71,154,225,2.1690140845070425,0,0.0,6.922307827
Lu,71,156,227,2.1971830985915495,0,0.0,6.866715665
Lu,71,158,229,2.2253521126760565,0,0.0,6.809342205
Hf,72,80,152,1.1111111111111112,0,1.0,7.849149079
Hf,72,81,153,1.125,0,0.0,7.877847144
Hf,72,82,154,1.1388888888888888,1,1.0,7.920345292
Hf,72,83,155,1.1527777777777777,0,0.0,7.923305555
Hf,72,84,156,1.1666666666666667,0,1.0,7.940249526
Hf,72,85,157,1.1805555555555556,0,0.0,7.948087172
Hf,72,86,158,1.1944444444444444,0,1.0,7.96525631
Hf,72,87,159,1.2083333333333333,0,0.0,7.971578409
Hf,72,88,160,1.2222222222222223,0,1.0,7.98749755
Hf,72,89,161,1.2361111111111112,0,0.0,7.990429857
Hf,72,90,162,1.25,0,1.0,8.003417235
Hf,72,91,163,1.2638888888888888,0,0.0,8.004082307
Hf,72,92,164,1.2777777777777777,0,1.0,8.014889024
Hf,72,93,165,1.2916666666666667,0,0.0,8.014676533
Hf,72,94,166,1.3055555555555556,0,1.0,8.024646711
Hf,72,95,167,1.3194444444444444,0,0.0,8.023592347
Hf,72,96,168,1.3333333333333333,0,1.0,8.03263447
Hf,72,97,169,1.3472222222222223,0,0.0,8.030727633
Hf,72,98,170,1.3611111111111112,0,1.0,8.038654076
Hf,72,99,171,1.375,0,0.0,8.035163088
Hf,72,100,172,1.3888888888888888,0,1.0,8.041273128
Hf,72,101,173,1.4027777777777777,0,0.0,8.034324763
Hf,72,102,174,1.4166666666666667,0,1.0,8.036717868
Hf,72,103,175,1.4305555555555556,0,0.0,8.026782886
Hf,72,104,176,1.4444444444444444,0,1.0,8.025909301
Hf,72,105,177,1.4583333333333333,0,0.0,8.014307825
Hf,72,106,178,1.4722222222222223,0,1.0,8.011503225
Hf,72,107,179,1.4861111111111112,0,0.0,7.998484475
Hf,72,108,180,1.5,0,1.0,7.993837539
Hf,72,109,181,1.5138888888888888,0,0.0,7.980126541
Hf,72,110,182,1.5277777777777777,0,1.0,7.974495846
Hf,72,111,183,1.5416666666666667,0,0.0,7.95883318
Hf,72,112,184,1.5555555555555556,0,1.0,7.951512033
Hf,72,113,185,1.5694444444444444,0,0.0,7.932193438
Hf,72,114,186,1.5833333333333333,0,1.0,7.921243554
Hf,72,115,187,1.5972222222222223,0,0.0,7.900180176
Hf,72,116,188,1.6111111111111112,0,1.0,7.887212282
Hf,72,117,189,1.625,0,0.0,7.868215476
Hf,72,118,190,1.6388888888888888,0,1.0,7.857321242
Hf,72,119,191,1.6527777777777777,0,0.0,7.837218513
Hf,72,120,192,1.6666666666666667,0,1.0,7.82492787
Hf,72,121,193,1.6805555555555556,0,0.0,7.805700544
Hf,72,122,194,1.6944444444444444,0,1.0,7.793907216
Hf,72,123,195,1.7083333333333333,0,0.0,7.775088785
Hf,72,124,196,1.7222222222222223,0,1.0,7.764163934
Hf,72,125,197,1.7361111111111112,0,0.0,7.744217528
Hf,72,126,198,1.75,1,1.0,7.734889207
Hf,72,127,199,1.7638888888888888,0,0.0,7.700338608
Hf,72,128,200,1.7777777777777777,0,1.0,7.67548564
Hf,72,129,201,1.7916666666666667,0,0.0,7.642388104
Hf,72,130,202,1.8055555555555556,0,1.0,7.616029248
Hf,72,131,203,1.8194444444444444,0,0.0,7.584655153
Hf,72,132,204,1.8333333333333333,0,1.0,7.560396152
Hf,72,133,205,1.8472222222222223,0,0.0,7.529374005
Hf,72,134,206,1.8611111111111112,0,1.0,7.5056905
Hf,72,135,207,1.875,0,0.0,7.474588101
Hf,72,136,208,1.8888888888888888,0,1.0,7.450986409
Hf,72,137,209,1.9027777777777777,0,0.0,7.420537689
Hf,72,138,210,1.9166666666666667,0,1.0,7.397639733
Hf,72,139,211,1.9305555555555556,0,0.0,7.367898711
Hf,72,140,212,1.9444444444444444,0,1.0,7.345666066
Hf,72,141,213,1.9583333333333333,0,0.0,7.316265286
Hf,72,142,214,1.9722222222222223,0,1.0,7.294272495
Hf,72,143,215,1.9861111111111112,0,0.0,7.265000377
Hf,72,144,216,2.0,0,1.0,7.24306613
Hf,72,145,217,2.013888888888889,0,0.0,7.213464677
Hf,72,146,218,2.0277777777777777,0,1.0,7.191176289
Hf,72,147,219,2.0416666666666665,0,0.0,7.160800671
Hf,72,148,220,2.0555555555555554,0,1.0,7.137643045
Hf,72,149,221,2.0694444444444446,0,0.0,7.106790783
Hf,72,150,222,2.0833333333333335,0,1.0,7.082960104
Hf,72,151,223,2.0972222222222223,0,0.0,7.052121314
Hf,72,152,224,2.111111111111111,0,1.0,7.028102567
Hf,72,153,225,2.125,0,0.0,6.997506369
Hf,72,154,226,2.138888888888889,0,1.0,6.973565013
Hf,72,155,227,2.1527777777777777,0,0.0,6.943130009
Hf,72,156,228,2.1666666666666665,0,1.0,6.919323079
Hf,72,158,230,2.1944444444444446,0,1.0,6.863470717
Hf,72,160,232,2.2222222222222223,0,1.0,6.804550918
Ta,73,82,155,1.1232876712328768,1,0.0,7.864088323
Ta,73,84,157,1.1506849315068493,0,0.0,7.888349637
Ta,73,85,158,1.1643835616438356,0,-1.0,7.898038057
Ta,73,86,159,1.178082191780822,0,0.0,7.916983214
Ta,73,87,160,1.1917808219178083,0,-1.0,7.925254344
Ta,73,88,161,1.2054794520547945,0,0.0,7.943044677
Ta,73,89,162,1.2191780821917808,0,-1.0,7.947969969
Ta,73,90,163,1.2328767123287672,0,0.0,7.962895135
Ta,73,91,164,1.2465753424657535,0,-1.0,7.965302543
Ta,73,92,165,1.2602739726027397,0,0.0,7.977849982
Ta,73,93,166,1.273972602739726,0,-1.0,7.978935187
Ta,73,94,167,1.2876712328767124,0,0.0,7.990217293
Ta,73,95,168,1.3013698630136987,0,-1.0,7.990306423
Ta,73,96,169,1.3150684931506849,0,0.0,8.000464669
Ta,73,97,170,1.3287671232876712,0,-1.0,8.000013953
Ta,73,98,171,1.3424657534246576,0,0.0,8.009274743
Ta,73,99,172,1.356164383561644,0,-1.0,8.007131645
Ta,73,100,173,1.36986301369863,0,0.0,8.014422659
Ta,73,101,174,1.3835616438356164,0,-1.0,8.009007247
Ta,73,102,175,1.3972602739726028,0,0.0,8.012783046
Ta,73,103,176,1.4109589041095891,0,-1.0,8.004625926
Ta,73,104,177,1.4246575342465753,0,0.0,8.005437237
Ta,73,105,178,1.4383561643835616,0,-1.0,7.99593073
Ta,73,106,179,1.452054794520548,0,0.0,7.995224134
Ta,73,107,180,1.4657534246575343,0,-1.0,7.984159572
Ta,73,108,181,1.4794520547945205,0,0.0,7.981527569
Ta,73,109,182,1.4931506849315068,0,-1.0,7.969550538
Ta,73,110,183,1.5068493150684932,0,0.0,7.965684459
Ta,73,111,184,1.5205479452054795,0,-1.0,7.95186356
Ta,73,112,185,1.5342465753424657,0,0.0,7.946264449
Ta,73,113,186,1.547945205479452,0,-1.0,7.929270763
Ta,73,114,187,1.5616438356164384,0,0.0,7.920464492
Ta,73,115,188,1.5753424657534247,0,-1.0,7.901800234
Ta,73,116,189,1.5890410958904109,0,0.0,7.891096206
Ta,73,117,190,1.6027397260273972,0,-1.0,7.873049879
Ta,73,118,191,1.6164383561643836,0,0.0,7.862947827
Ta,73,119,192,1.63013698630137,0,-1.0,7.844562266
Ta,73,120,193,1.643835616438356,0,0.0,7.83382542
Ta,73,121,194,1.6575342465753424,0,-1.0,7.816509242
Ta,73,122,195,1.6712328767123288,0,0.0,7.806540815
Ta,73,123,196,1.6849315068493151,0,-1.0,7.788884388
Ta,73,124,197,1.6986301369863013,0,0.0,7.779110782
Ta,73,125,198,1.7123287671232876,0,-1.0,7.760001838
Ta,73,126,199,1.726027397260274,1,0.0,7.75148395
Ta,73,127,200,1.7397260273972603,0,-1.0,7.718066215
Ta,73,128,201,1.7534246575342465,0,0.0,7.69431093
Ta,73,129,202,1.7671232876712328,0,-1.0,7.662216168
Ta,73,130,203,1.7808219178082192,0,0.0,7.636858882
Ta,73,131,204,1.7945205479452055,0,-1.0,7.606408186
Ta,73,132,205,1.8082191780821917,0,0.0,7.583084854
Ta,73,133,206,1.821917808219178,0,-1.0,7.552988335
Ta,73,134,207,1.8356164383561644,0,0.0,7.530250565
Ta,73,135,208,1.8493150684931507,0,-1.0,7.50005599
Ta,73,136,209,1.8630136986301369,0,0.0,7.477390986
Ta,73,137,210,1.8767123287671232,0,-1.0,7.447646376
Ta,73,138,211,1.8904109589041096,0,0.0,7.425498872
Ta,73,139,212,1.904109589041096,0,-1.0,7.396444311
Ta,73,140,213,1.917808219178082,0,0.0,7.374926507
Ta,73,141,214,1.9315068493150684,0,-1.0,7.34645793
Ta,73,142,215,1.9452054794520548,0,0.0,7.325360298
Ta,73,143,216,1.9589041095890412,0,-1.0,7.297092514
Ta,73,144,217,1.9726027397260273,0,0.0,7.276073332
Ta,73,145,218,1.9863013698630136,0,-1.0,7.247398023
Ta,73,146,219,2.0,0,0.0,7.225940881
Ta,73,147,220,2.0136986301369864,0,-1.0,7.196388577
Ta,73,148,221,2.0273972602739727,0,0.0,7.173967937
Ta,73,149,222,2.041095890410959,0,-1.0,7.143798802
Ta,73,150,223,2.0547945205479454,0,0.0,7.120571103
Ta,73,151,224,2.0684931506849313,0,-1.0,7.090316219
Ta,73,152,225,2.0821917808219177,0,0.0,7.066796973
Ta,73,153,226,2.095890410958904,0,-1.0,7.036765004
Ta,73,154,227,2.1095890410958904,0,0.0,7.013302921
Ta,73,155,228,2.1232876712328768,0,-1.0,6.983524162
Ta,73,156,229,2.136986301369863,0,0.0,6.960302498
Ta,73,158,231,2.164383561643836,0,0.0,6.905981433
Ta,73,160,233,2.191780821917808,0,0.0,6.849075614
Ta,73,162,235,2.219178082191781,0,0.0,6.791389753
W,74,82,156,1.1081081081081081,1,1.0,7.821137744
W,74,83,157,1.1216216216216217,0,0.0,7.828038599
W,74,84,158,1.135135135135135,0,1.0,7.848686354
W,74,85,159,1.1486486486486487,0,0.0,7.859484403
W,74,86,160,1.162162162162162,0,1.0,7.879474631
W,74,87,161,1.1756756756756757,0,0.0,7.889386453
W,74,88,162,1.1891891891891893,0,1.0,7.908744407
W,74,89,163,1.2027027027027026,0,0.0,7.915439902
W,74,90,164,1.2162162162162162,0,1.0,7.932083451
W,74,91,165,1.2297297297297298,0,0.0,7.93604477
W,74,92,166,1.2432432432432432,0,1.0,7.950146783
W,74,93,167,1.2567567567567568,0,0.0,7.952408934
W,74,94,168,1.2702702702702702,0,1.0,7.964883482
W,74,95,169,1.2837837837837838,0,0.0,7.966061645
W,74,96,170,1.2972972972972974,0,1.0,7.977282512
W,74,97,171,1.3108108108108107,0,0.0,7.978144398
W,74,98,172,1.3243243243243243,0,1.0,7.988599087
W,74,99,173,1.337837837837838,0,0.0,7.987704289
W,74,100,174,1.3513513513513513,0,1.0,7.996079759
W,74,101,175,1.364864864864865,0,0.0,7.992020451
W,74,102,176,1.3783783783783783,0,1.0,7.997005813
W,74,103,177,1.3918918918918919,0,0.0,7.990396124
W,74,104,178,1.4054054054054055,0,1.0,7.992665539
W,74,105,179,1.4189189189189189,0,0.0,7.985042106
W,74,106,180,1.4324324324324325,0,1.0,7.986223956
W,74,107,181,1.445945945945946,0,0.0,7.976876564
W,74,108,182,1.4594594594594594,0,1.0,7.976024429
W,74,109,183,1.472972972972973,0,0.0,7.965595956
W,74,110,184,1.4864864864864864,0,1.0,7.963310761
W,74,111,185,1.5,0,0.0,7.951213086
W,74,112,186,1.5135135135135136,0,1.0,7.947220027
W,74,113,187,1.527027027027027,0,0.0,7.93254554
W,74,114,188,1.5405405405405406,0,1.0,7.925879176
W,74,115,189,1.554054054054054,0,0.0,7.909806915
W,74,116,190,1.5675675675675675,0,1.0,7.901559032
W,74,117,191,1.5810810810810811,0,0.0,7.884540859
W,74,118,192,1.5945945945945945,0,1.0,7.87530951
W,74,119,193,1.6081081081081081,0,0.0,7.858644611
W,74,120,194,1.6216216216216217,0,1.0,7.849466706
W,74,121,195,1.635135135135135,0,0.0,7.83428919
W,74,122,196,1.6486486486486487,0,1.0,7.82637173
W,74,123,197,1.662162162162162,0,0.0,7.810149721
W,74,124,198,1.6756756756756757,0,1.0,7.801797126
W,74,125,199,1.6891891891891893,0,0.0,7.783814241
W,74,126,200,1.7027027027027026,1,1.0,7.776392765
W,74,127,201,1.7162162162162162,0,0.0,7.744018114
W,74,128,202,1.7297297297297298,0,1.0,7.72127196
W,74,129,203,1.7432432432432432,0,0.0,7.689929251
W,74,130,204,1.7567567567567568,0,1.0,7.665325284
W,74,131,205,1.7702702702702702,0,0.0,7.635323117
W,74,132,206,1.7837837837837838,0,1.0,7.612465058
W,74,133,207,1.7972972972972974,0,0.0,7.583074275
W,74,134,208,1.8108108108108107,0,1.0,7.561064274
W,74,135,209,1.8243243243243243,0,0.0,7.531653885
W,74,136,210,1.837837837837838,0,1.0,7.509802829
W,74,137,211,1.8513513513513513,0,0.0,7.480697948
W,74,138,212,1.864864864864865,0,1.0,7.459236703
W,74,139,213,1.8783783783783783,0,0.0,7.430859817
W,74,140,214,1.8918918918918919,0,1.0,7.410047869
W,74,141,215,1.9054054054054055,0,0.0,7.382453823
W,74,142,216,1.9189189189189189,0,1.0,7.362194551
W,74,143,217,1.9324324324324325,0,0.0,7.33487188
W,74,144,218,1.945945945945946,0,1.0,7.314709922
W,74,145,219,1.9594594594594594,0,0.0,7.286922105
W,74,146,220,1.972972972972973,0,1.0,7.266258768
W,74,147,221,1.9864864864864864,0,0.0,7.237486118
W,74,148,222,2.0,0,1.0,7.215759964
W,74,149,223,2.0135135135135136,0,0.0,7.186222601
W,74,150,224,2.027027027027027,0,1.0,7.163547701
W,74,151,225,2.0405405405405403,0,0.0,7.133809729
W,74,152,226,2.054054054054054,0,1.0,7.110724323
W,74,153,227,2.0675675675675675,0,0.0,7.08119037
W,74,154,228,2.081081081081081,0,1.0,7.058142671
W,74,155,229,2.0945945945945947,0,0.0,7.02895714
W,74,156,230,2.108108108108108,0,1.0,7.006258887
W,74,157,231,2.1216216216216215,0,0.0,6.976496416
W,74,158,232,2.135135135135135,0,1.0,6.953350017
W,74,160,234,2.1621621621621623,0,1.0,6.898339141
W,74,162,236,2.189189189189189,0,1.0,6.84261875
W,74,164,238,2.2162162162162162,0,1.0,6.786851597
W,74,166,240,2.2432432432432434,0,1.0,6.731085675
Re,75,84,159,1.12,0,0.0,7.793697415
Re,75,86,161,1.1466666666666667,0,0.0,7.827152671
Re,75,88,163,1.1733333333333333,0,0.0,7.859182693
Re,75,89,164,1.1866666666666668,0,-1.0,7.867468616
Re,75,90,165,1.2,0,0.0,7.885696424
Re,75,91,166,1.2133333333333334,0,-1.0,7.891223175
Re,75,92,167,1.2266666666666666,0,0.0,7.906936389
Re,75,93,168,1.24,0,-1.0,7.910503256
Re,75,94,169,1.2533333333333334,0,0.0,7.924366858
Re,75,95,170,1.2666666666666666,0,-1.0,7.927310435
Re,75,96,171,1.28,0,0.0,7.940193795
Re,75,97,172,1.2933333333333332,0,-1.0,7.942817599
Re,75,98,173,1.3066666666666666,0,0.0,7.954820653
Re,75,99,174,1.32,0,-1.0,7.955339172
Re,75,100,175,1.3333333333333333,0,0.0,7.964999571
Re,75,101,176,1.3466666666666667,0,-1.0,7.962558045
Re,75,102,177,1.36,0,0.0,7.969050356
Re,75,103,178,1.3733333333333333,0,-1.0,7.964183899
Re,75,104,179,1.3866666666666667,0,0.0,7.96810943
Re,75,105,180,1.4,0,-1.0,7.962182267
Re,75,106,181,1.4133333333333333,0,0.0,7.965024304
Re,75,107,182,1.4266666666666667,0,-1.0,7.957431467
Re,75,108,183,1.44,0,0.0,7.958361158
Re,75,109,184,1.4533333333333334,0,-1.0,7.949626234
Re,75,110,185,1.4666666666666666,0,0.0,7.949075935
Re,75,111,186,1.48,0,-1.0,7.938787548
Re,75,112,187,1.4933333333333334,0,0.0,7.936583481
Re,75,113,188,1.5066666666666666,0,-1.0,7.924072271
Re,75,114,189,1.52,0,0.0,7.919539836
Re,75,115,190,1.5333333333333334,0,-1.0,7.905658858
Re,75,116,191,1.5466666666666666,0,0.0,7.89964266
Re,75,117,192,1.56,0,-1.0,7.884588724
Re,75,118,193,1.5733333333333333,0,0.0,7.87735844
Re,75,119,194,1.5866666666666667,0,-1.0,7.862255943
Re,75,120,195,1.6,0,0.0,7.854644856
Re,75,121,196,1.6133333333333333,0,-1.0,7.841092694
Re,75,122,197,1.6266666666666667,0,0.0,7.834799832
Re,75,123,198,1.64,0,-1.0,7.819754333
Re,75,124,199,1.6533333333333333,0,0.0,7.812546402
Re,75,125,200,1.6666666666666667,0,-1.0,7.79561445
Re,75,126,201,1.68,1,0.0,7.78917099
Re,75,127,202,1.6933333333333334,0,-1.0,7.757947342
Re,75,128,203,1.7066666666666668,0,0.0,7.736306074
Re,75,129,204,1.72,0,-1.0,7.705818118
Re,75,130,205,1.7333333333333334,0,0.0,7.682063502
Re,75,131,206,1.7466666666666666,0,-1.0,7.652820417
Re,75,132,207,1.76,0,0.0,7.630793778
Re,75,133,208,1.7733333333333334,0,-1.0,7.602008524
Re,75,134,209,1.7866666666666666,0,0.0,7.580710062
Re,75,135,210,1.8,0,-1.0,7.551980481
Re,75,136,211,1.8133333333333332,0,0.0,7.530879872
Re,75,137,212,1.8266666666666667,0,-1.0,7.502336557
Re,75,138,213,1.84,0,0.0,7.481519113
Re,75,139,214,1.8533333333333333,0,-1.0,7.453667103
Re,75,140,215,1.8666666666666667,0,0.0,7.433412014
Re,75,141,216,1.88,0,-1.0,7.407113708
Re,75,142,217,1.8933333333333333,0,0.0,7.388071212
Re,75,143,218,1.9066666666666667,0,-1.0,7.361747885
Re,75,144,219,1.92,0,0.0,7.34247547
Re,75,145,220,1.9333333333333333,0,-1.0,7.315537845
Re,75,146,221,1.9466666666666668,0,0.0,7.295625448
Re,75,147,222,1.96,0,-1.0,7.267655752
Re,75,148,223,1.9733333333333334,0,0.0,7.246646673
Re,75,149,224,1.9866666666666666,0,-1.0,7.217858638
Re,75,150,225,2.0,0,0.0,7.195868013
Re,75,151,226,2.013333333333333,0,-1.0,7.166818659
Re,75,152,227,2.026666666666667,0,0.0,7.144360176
Re,75,153,228,2.04,0,-1.0,7.115503149
Re,75,154,229,2.0533333333333332,0,0.0,7.093065319
Re,75,155,230,2.066666666666667,0,-1.0,7.064553617
Re,75,156,231,2.08,0,0.0,7.042455113
Re,75,157,232,2.0933333333333333,0,-1.0,7.013457172
Re,75,158,233,2.1066666666666665,0,0.0,6.990995876
Re,75,159,234,2.12,0,-1.0,6.961130893
Re,75,160,235,2.1333333333333333,0,0.0,6.937706987
Re,75,162,237,2.16,0,0.0,6.88372157
Re,75,164,239,2.1866666666666665,0,0.0,6.82954146
Re,75,166,241,2.2133333333333334,0,0.0,6.775344071
Re,75,168,243,2.24,0,0.0,6.721412235
Re,75,170,245,2.2666666666666666,0,0.0,6.667476955
Re,75,176,251,2.3466666666666667,0,0.0,6.503504251
Re,75,184,259,2.453333333333333,0,0.0,6.302525892
Os,76,85,161,1.118421052631579,0,0.0,7.763053329
Os,76,86,162,1.131578947368421,0,1.0,7.784903019
Os,76,87,163,1.144736842105263,0,0.0,7.79720689
Os,76,88,164,1.1578947368421053,0,1.0,7.818975238
Os,76,89,165,1.1710526315789473,0,0.0,7.828664897
Os,76,90,166,1.1842105263157894,0,1.0,7.848292602
Os,76,91,167,1.1973684210526316,0,0.0,7.855277952
Os,76,92,168,1.2105263157894737,0,1.0,7.872496262
Os,76,93,169,1.2236842105263157,0,0.0,7.877325793
Os,76,94,170,1.236842105263158,0,1.0,7.892535888
Os,76,95,171,1.25,0,0.0,7.897485088
Os,76,96,172,1.263157894736842,0,1.0,7.912269541
Os,76,97,173,1.2763157894736843,0,0.0,7.916542532
Os,76,98,174,1.2894736842105263,0,1.0,7.929984977
Os,76,99,175,1.3026315789473684,0,0.0,7.931778874
Os,76,100,176,1.3157894736842106,0,1.0,7.942589301
Os,76,101,177,1.3289473684210527,0,0.0,7.941620147
Os,76,102,178,1.3421052631578947,0,1.0,7.949476888
Os,76,103,179,1.355263157894737,0,0.0,7.946147665
Os,76,104,180,1.368421052631579,0,1.0,7.951526578
Os,76,105,181,1.381578947368421,0,0.0,7.94716811
Os,76,106,182,1.394736842105263,0,1.0,7.951544555
Os,76,107,183,1.4078947368421053,0,0.0,7.94560077
Os,76,108,184,1.4210526315789473,0,1.0,7.94820763
Os,76,109,185,1.4342105263157894,0,0.0,7.941048438
Os,76,110,186,1.4473684210526316,0,1.0,7.942116038
Os,76,111,187,1.4605263157894737,0,0.0,7.933491294
Os,76,112,188,1.4736842105263157,0,1.0,7.93293234
Os,76,113,189,1.486842105263158,0,0.0,7.922447926
Os,76,114,190,1.5,0,1.0,7.919914695
Os,76,115,191,1.513157894736842,0,0.0,7.908192304
Os,76,116,192,1.5263157894736843,0,1.0,7.904375
Os,76,117,193,1.5394736842105263,0,0.0,7.891321093
Os,76,118,194,1.5526315789473684,0,1.0,7.886126912
Os,76,119,195,1.5657894736842106,0,0.0,7.872483544
Os,76,120,196,1.5789473684210527,0,1.0,7.86633701
Os,76,121,197,1.5921052631578947,0,0.0,7.854536386
Os,76,122,198,1.605263157894737,0,1.0,7.84999304
Os,76,123,199,1.618421052631579,0,0.0,7.836370045
Os,76,124,200,1.631578947368421,0,1.0,7.83055062
Os,76,125,201,1.644736842105263,0,0.0,7.814983547
Os,76,126,202,1.6578947368421053,1,1.0,7.809829658
Os,76,127,203,1.6710526315789473,0,0.0,7.779681985
Os,76,128,204,1.6842105263157894,0,1.0,7.75907176
Os,76,129,205,1.6973684210526316,0,0.0,7.7292596
Os,76,130,206,1.7105263157894737,0,1.0,7.706177165
Os,76,131,207,1.7236842105263157,0,0.0,7.677225072
Os,76,132,208,1.736842105263158,0,1.0,7.655565548
Os,76,133,209,1.75,0,0.0,7.627082756
Os,76,134,210,1.763157894736842,0,1.0,7.606194633
Os,76,135,211,1.7763157894736843,0,0.0,7.578014085
Os,76,136,212,1.7894736842105263,0,1.0,7.557532736
Os,76,137,213,1.8026315789473684,0,0.0,7.529507146
Os,76,138,214,1.8157894736842106,0,1.0,7.509289308
Os,76,139,215,1.8289473684210527,0,0.0,7.482066605
Os,76,140,216,1.8421052631578947,0,1.0,7.462471537
Os,76,141,217,1.855263157894737,0,0.0,7.437501733
Os,76,142,218,1.868421052631579,0,1.0,7.419709193
Os,76,143,219,1.881578947368421,0,0.0,7.394364626
Os,76,144,220,1.894736842105263,0,1.0,7.375962364
Os,76,145,221,1.9078947368421053,0,0.0,7.349834774
Os,76,146,222,1.9210526315789473,0,1.0,7.330634405
Os,76,147,223,1.9342105263157894,0,0.0,7.303397928
Os,76,148,224,1.9473684210526316,0,1.0,7.283037571
Os,76,149,225,1.9605263157894737,0,0.0,7.254903596
Os,76,150,226,1.9736842105263157,0,1.0,7.233503389
Os,76,151,227,1.986842105263158,0,0.0,7.205038577
Os,76,152,228,2.0,0,1.0,7.183104386
Os,76,153,229,2.013157894736842,0,0.0,7.154826808
Os,76,154,230,2.026315789473684,0,1.0,7.1329028
Os,76,155,231,2.039473684210526,0,0.0,7.104990593
Os,76,156,232,2.0526315789473686,0,1.0,7.083418776
Os,76,157,233,2.0657894736842106,0,0.0,7.055134202
Os,76,158,234,2.0789473684210527,0,1.0,7.033307953
Os,76,159,235,2.0921052631578947,0,0.0,7.004300128
Os,76,160,236,2.1052631578947367,0,1.0,6.981684547
Os,76,161,237,2.1184210526315788,0,0.0,6.952490219
Os,76,162,238,2.1315789473684212,0,1.0,6.929425307
Os,76,164,240,2.1578947368421053,0,1.0,6.876806788
Os,76,166,242,2.1842105263157894,0,1.0,6.824126074
Os,76,168,244,2.210526315789474,0,1.0,6.771863967
Os,76,170,246,2.236842105263158,0,1.0,6.719783573
Os,76,172,248,2.263157894736842,0,1.0,6.666200315
Os,76,176,252,2.3157894736842106,0,1.0,6.561094103
Os,76,178,254,2.3421052631578947,0,1.0,6.510783992
Os,76,180,256,2.3684210526315788,0,1.0,6.460997621
Os,76,182,258,2.3947368421052633,0,1.0,6.411933853
Os,76,184,260,2.4210526315789473,0,1.0,6.364700615
Ir,77,88,165,1.1428571428571428,0,0.0,7.766427612
Ir,77,90,167,1.1688311688311688,0,0.0,7.798535898
Ir,77,92,169,1.1948051948051948,0,0.0,7.825671633
Ir,77,93,170,1.2077922077922079,0,-1.0,7.831738941
Ir,77,94,171,1.2207792207792207,0,0.0,7.848373351
Ir,77,95,172,1.2337662337662338,0,-1.0,7.854096709
Ir,77,96,173,1.2467532467532467,0,0.0,7.869719243
Ir,77,97,174,1.2597402597402598,0,-1.0,7.875531828
Ir,77,98,175,1.2727272727272727,0,0.0,7.890440166
Ir,77,99,176,1.2857142857142858,0,-1.0,7.893905813
Ir,77,100,177,1.2987012987012987,0,0.0,7.906312938
Ir,77,101,178,1.3116883116883118,0,-1.0,7.907119056
Ir,77,102,179,1.3246753246753247,0,0.0,7.91666319
Ir,77,103,180,1.3376623376623376,0,-1.0,7.915128394
Ir,77,104,181,1.3506493506493507,0,0.0,7.922204878
Ir,77,105,182,1.3636363636363635,0,-1.0,7.91909867
Ir,77,106,183,1.3766233766233766,0,0.0,7.924617044
Ir,77,107,184,1.3896103896103895,0,-1.0,7.919698701
Ir,77,108,185,1.4025974025974026,0,0.0,7.92323773
Ir,77,109,186,1.4155844155844155,0,-1.0,7.917211672
Ir,77,110,187,1.4285714285714286,0,0.0,7.919722449
Ir,77,111,188,1.4415584415584415,0,-1.0,7.913062473
Ir,77,112,189,1.4545454545454546,0,0.0,7.915093751
Ir,77,113,190,1.4675324675324675,0,-1.0,7.907019689
Ir,77,114,191,1.4805194805194806,0,0.0,7.90739133
Ir,77,115,192,1.4935064935064934,0,-1.0,7.898006974
Ir,77,116,193,1.5064935064935066,0,0.0,7.896812409
Ir,77,117,194,1.5194805194805194,0,-1.0,7.885984593
Ir,77,118,195,1.5324675324675325,0,0.0,7.883068969
Ir,77,119,196,1.5454545454545454,0,-1.0,7.871585393
Ir,77,120,197,1.5584415584415585,0,0.0,7.867600193
Ir,77,121,198,1.5714285714285714,0,-1.0,7.857261359
Ir,77,122,199,1.5844155844155845,0,0.0,7.854205327
Ir,77,123,200,1.5974025974025974,0,-1.0,7.84166183
Ir,77,124,201,1.6103896103896105,0,0.0,7.836817826
Ir,77,125,202,1.6233766233766234,0,-1.0,7.822866901
Ir,77,126,203,1.6363636363636365,1,0.0,7.81918432
Ir,77,127,204,1.6493506493506493,0,-1.0,7.790152686
Ir,77,128,205,1.6623376623376624,0,0.0,7.770617546
Ir,77,129,206,1.6753246753246753,0,-1.0,7.741800515
Ir,77,130,207,1.6883116883116882,0,0.0,7.719713029
Ir,77,131,208,1.7012987012987013,0,-1.0,7.691343433
Ir,77,132,209,1.7142857142857142,0,0.0,7.670315947
Ir,77,133,210,1.7272727272727273,0,-1.0,7.642300829
Ir,77,134,211,1.7402597402597402,0,0.0,7.622038398
Ir,77,135,212,1.7532467532467533,0,-1.0,7.594363217
Ir,77,136,213,1.7662337662337662,0,0.0,7.5745857
Ir,77,137,214,1.7792207792207793,0,-1.0,7.547009579
Ir,77,138,215,1.7922077922077921,0,0.0,7.527410386
Ir,77,139,216,1.8051948051948052,0,-1.0,7.500741495
Ir,77,140,217,1.8181818181818181,0,0.0,7.481686111
Ir,77,141,218,1.8311688311688312,0,-1.0,7.457421413
Ir,77,142,219,1.844155844155844,0,0.0,7.440197822
Ir,77,143,220,1.8571428571428572,0,-1.0,7.415554391
Ir,77,144,221,1.87012987012987,0,0.0,7.397778303
Ir,77,145,222,1.8831168831168832,0,-1.0,7.372461113
Ir,77,146,223,1.896103896103896,0,0.0,7.353998632
Ir,77,147,224,1.9090909090909092,0,-1.0,7.327712286
Ir,77,148,225,1.922077922077922,0,0.0,7.308237427
Ir,77,149,226,1.9350649350649352,0,-1.0,7.281087159
Ir,77,150,227,1.948051948051948,0,0.0,7.260619388
Ir,77,151,228,1.9610389610389611,0,-1.0,7.233053364
Ir,77,152,229,1.974025974025974,0,0.0,7.211963258
Ir,77,153,230,1.9870129870129871,0,-1.0,7.184499761
Ir,77,154,231,2.0,0,0.0,7.163318255
Ir,77,155,232,2.012987012987013,0,-1.0,7.136167935
Ir,77,156,233,2.0259740259740258,0,0.0,7.11527288
Ir,77,157,234,2.038961038961039,0,-1.0,7.087697504
Ir,77,158,235,2.051948051948052,0,0.0,7.066495596
Ir,77,159,236,2.064935064935065,0,-1.0,7.038122602
Ir,77,160,237,2.0779220779220777,0,0.0,7.016082017
Ir,77,161,238,2.090909090909091,0,-1.0,6.987404248
Ir,77,162,239,2.103896103896104,0,0.0,6.964821314
Ir,77,163,240,2.116883116883117,0,-1.0,6.936049125
Ir,77,164,241,2.1298701298701297,0,0.0,6.913125917
Ir,77,165,242,2.142857142857143,0,-1.0,6.884610455
Ir,77,166,243,2.155844155844156,0,0.0,6.861771844
Ir,77,167,244,2.168831168831169,0,-1.0,6.833732717
Ir,77,168,245,2.1818181818181817,0,0.0,6.81132722
Ir,77,170,247,2.207792207792208,0,0.0,6.761131725
Ir,77,172,249,2.2337662337662336,0,0.0,6.709850092
Ir,77,174,251,2.25974025974026,0,0.0,6.659003016
Ir,77,176,253,2.2857142857142856,0,0.0,6.61056017
Ir,77,178,255,2.311688311688312,0,0.0,6.561614
Ir,77,180,257,2.3376623376623376,0,0.0,6.512898113
Ir,77,182,259,2.3636363636363638,0,0.0,6.464905402
Ir,77,184,261,2.3896103896103895,0,0.0,6.418468674
Pt,78,89,167,1.141025641025641,0,0.0,7.734635317
Pt,78,90,168,1.1538461538461537,0,1.0,7.756922161
Pt,78,91,169,1.1666666666666667,0,0.0,7.766548657
Pt,78,92,170,1.1794871794871795,0,1.0,7.7867065
Pt,78,93,171,1.1923076923076923,0,0.0,7.79396731
Pt,78,94,172,1.205128205128205,0,1.0,7.811980105
Pt,78,95,173,1.2179487179487178,0,0.0,7.819135624
Pt,78,96,174,1.2307692307692308,0,1.0,7.836245954
Pt,78,97,175,1.2435897435897436,0,0.0,7.843576949
Pt,78,98,176,1.2564102564102564,0,1.0,7.859931102
Pt,78,99,177,1.2692307692307692,0,0.0,7.864964395
Pt,78,100,178,1.2820512820512822,0,1.0,7.878866124
Pt,78,101,179,1.294871794871795,0,0.0,7.881334084
Pt,78,102,180,1.3076923076923077,0,1.0,7.892454439
Pt,78,103,181,1.3205128205128205,0,0.0,7.892569392
Pt,78,104,182,1.3333333333333333,0,1.0,7.901201423
Pt,78,105,183,1.3461538461538463,0,0.0,7.899225689
Pt,78,106,184,1.358974358974359,0,1.0,7.905766734
Pt,78,107,185,1.3717948717948718,0,0.0,7.901739551
Pt,78,108,186,1.3846153846153846,0,1.0,7.906078909
Pt,78,109,187,1.3974358974358974,0,0.0,7.900962283
Pt,78,110,188,1.4102564102564104,0,1.0,7.904691622
Pt,78,111,189,1.4230769230769231,0,0.0,7.899868016
Pt,78,112,190,1.435897435897436,0,1.0,7.904355895
Pt,78,113,191,1.4487179487179487,0,0.0,7.898533356
Pt,78,114,192,1.4615384615384615,0,1.0,7.901647552
Pt,78,115,193,1.4743589743589745,0,0.0,7.894464777
Pt,78,116,194,1.4871794871794872,0,1.0,7.895754969
Pt,78,117,195,1.5,0,0.0,7.887069333
Pt,78,118,196,1.5128205128205128,0,1.0,7.886348673
Pt,78,119,197,1.5256410256410255,0,0.0,7.876953249
Pt,78,120,198,1.5384615384615385,0,1.0,7.875058444
Pt,78,121,199,1.5512820512820513,0,0.0,7.866239291
Pt,78,122,200,1.564102564102564,0,1.0,7.864727635
Pt,78,123,201,1.5769230769230769,0,0.0,7.853490831
Pt,78,124,202,1.5897435897435896,0,1.0,7.849848223
Pt,78,125,203,1.6025641025641026,0,0.0,7.837748803
Pt,78,126,204,1.6153846153846154,1,1.0,7.83577199
Pt,78,127,205,1.6282051282051282,0,0.0,7.807797746
Pt,78,128,206,1.641025641025641,0,1.0,7.789280005
Pt,78,129,207,1.6538461538461537,0,0.0,7.761358565
Pt,78,130,208,1.6666666666666667,0,1.0,7.740167452
Pt,78,131,209,1.6794871794871795,0,0.0,7.712103172
Pt,78,132,210,1.6923076923076923,0,1.0,7.691432733
Pt,78,133,211,1.705128205128205,0,0.0,7.663456787
Pt,78,134,212,1.7179487179487178,0,1.0,7.643394113
Pt,78,135,213,1.7307692307692308,0,0.0,7.616032221
Pt,78,136,214,1.7435897435897436,0,1.0,7.596766393
Pt,78,137,215,1.7564102564102564,0,0.0,7.569570219
Pt,78,138,216,1.7692307692307692,0,1.0,7.550519208
Pt,78,139,217,1.7820512820512822,0,0.0,7.52465606
Pt,78,140,218,1.794871794871795,0,1.0,7.506390119
Pt,78,141,219,1.8076923076923077,0,0.0,7.482887799
Pt,78,142,220,1.8205128205128205,0,1.0,7.466291159
Pt,78,143,221,1.8333333333333333,0,0.0,7.442358294
Pt,78,144,222,1.8461538461538463,0,1.0,7.425218396
Pt,78,145,223,1.858974358974359,0,0.0,7.40068835
Pt,78,146,224,1.8717948717948718,0,1.0,7.382941375
Pt,78,147,225,1.8846153846153846,0,0.0,7.35754852
Pt,78,148,226,1.8974358974358974,0,1.0,7.338903602
Pt,78,149,227,1.9102564102564104,0,0.0,7.312665097
Pt,78,150,228,1.9230769230769231,0,1.0,7.293058886
Pt,78,151,229,1.935897435897436,0,0.0,7.266321987
Pt,78,152,230,1.9487179487179487,0,1.0,7.246007374
Pt,78,153,231,1.9615384615384615,0,0.0,7.219298411
Pt,78,154,232,1.9743589743589745,0,1.0,7.198800978
Pt,78,155,233,1.9871794871794872,0,0.0,7.172356064
Pt,78,156,234,2.0,0,1.0,7.152082491
Pt,78,157,235,2.0128205128205128,0,0.0,7.125169736
Pt,78,158,236,2.0256410256410255,0,1.0,7.104546691
Pt,78,159,237,2.0384615384615383,0,0.0,7.076769435
Pt,78,160,238,2.051282051282051,0,1.0,7.05526558
Pt,78,161,239,2.0641025641025643,0,0.0,7.027071987
Pt,78,162,240,2.076923076923077,0,1.0,7.004939208
Pt,78,163,241,2.08974358974359,0,0.0,6.976608672
Pt,78,164,242,2.1025641025641026,0,1.0,6.954102459
Pt,78,165,243,2.1153846153846154,0,0.0,6.926192337
Pt,78,166,244,2.128205128205128,0,1.0,6.903968365
Pt,78,167,245,2.141025641025641,0,0.0,6.876722494
Pt,78,168,246,2.1538461538461537,0,1.0,6.855171874
Pt,78,169,247,2.1666666666666665,0,0.0,6.828024846
Pt,78,170,248,2.1794871794871793,0,1.0,6.806635052
Pt,78,172,250,2.2051282051282053,0,1.0,6.757453452
Pt,78,173,251,2.217948717948718,0,0.0,6.730993406
Pt,78,174,252,2.230769230769231,0,1.0,6.710368464
Pt,78,175,253,2.2435897435897436,0,0.0,6.684306344
Pt,78,176,254,2.2564102564102564,0,1.0,6.664085209
Pt,78,178,256,2.282051282051282,0,1.0,6.61657627
Pt,78,180,258,2.3076923076923075,0,1.0,6.569085453
Pt,78,182,260,2.3333333333333335,0,1.0,6.522652127
Pt,78,184,262,2.358974358974359,0,1.0,6.476949042
Au,79,92,171,1.1645569620253164,0,0.0,7.737620982
Au,79,94,173,1.1898734177215189,0,0.0,7.765722861
Au,79,96,175,1.2151898734177216,0,0.0,7.79086448
Au,79,98,177,1.240506329113924,0,0.0,7.815485175
Au,79,99,178,1.2531645569620253,0,-1.0,7.822235146
Au,79,100,179,1.2658227848101267,0,0.0,7.837786682
Au,79,101,180,1.2784810126582278,0,-1.0,7.842023672
Au,79,102,181,1.2911392405063291,0,0.0,7.854828674
Au,79,103,182,1.3037974683544304,0,-1.0,7.856613011
Au,79,104,183,1.3164556962025316,0,0.0,7.867264563
Au,79,105,184,1.3291139240506329,0,-1.0,7.867127408
Au,79,106,185,1.3417721518987342,0,0.0,7.876222281
Au,79,107,186,1.3544303797468353,0,-1.0,7.874226253
Au,79,108,187,1.3670886075949367,0,0.0,7.881274599
Au,79,109,188,1.379746835443038,0,-1.0,7.878300138
Au,79,110,189,1.3924050632911393,0,0.0,7.884521392
Au,79,111,190,1.4050632911392404,0,-1.0,7.881170437
Au,79,112,191,1.4177215189873418,0,0.0,7.887131126
Au,79,113,192,1.4303797468354431,0,-1.0,7.882740854
Au,79,114,193,1.4430379746835442,0,0.0,7.887289617
Au,79,115,194,1.4556962025316456,0,-1.0,7.881592995
Au,79,116,195,1.4683544303797469,0,0.0,7.884393867
Au,79,117,196,1.481012658227848,0,-1.0,7.877280082
Au,79,118,197,1.4936708860759493,0,0.0,7.878227112
Au,79,119,198,1.5063291139240507,0,-1.0,7.870587227
Au,79,120,199,1.518987341772152,0,0.0,7.870622975
Au,79,121,200,1.5316455696202531,0,-1.0,7.863387735
Au,79,122,201,1.5443037974683544,0,0.0,7.863639368
Au,79,123,202,1.5569620253164558,0,-1.0,7.854414124
Au,79,124,203,1.5696202531645569,0,0.0,7.852866498
Au,79,125,204,1.5822784810126582,0,-1.0,7.842282672
Au,79,126,205,1.5949367088607596,1,0.0,7.841790527
Au,79,127,206,1.6075949367088607,0,-1.0,7.814924937
Au,79,128,207,1.620253164556962,0,0.0,7.797460357
Au,79,129,208,1.6329113924050633,0,-1.0,7.770617755
Au,79,130,209,1.6455696202531647,0,0.0,7.750485459
Au,79,131,210,1.6582278481012658,0,-1.0,7.72342101
Au,79,132,211,1.6708860759493671,0,0.0,7.70374982
Au,79,133,212,1.6835443037974684,0,-1.0,7.676570033
Au,79,134,213,1.6962025316455696,0,0.0,7.657403174
Au,79,135,214,1.7088607594936709,0,-1.0,7.630105182
Au,79,136,215,1.7215189873417722,0,0.0,7.611229563
Au,79,137,216,1.7341772151898733,0,-1.0,7.58410825
Au,79,138,217,1.7468354430379747,0,0.0,7.56552835
Au,79,139,218,1.759493670886076,0,-1.0,7.539549225
Au,79,140,219,1.7721518987341771,0,0.0,7.521327329
Au,79,141,220,1.7848101265822784,0,-1.0,7.498320086
Au,79,142,221,1.7974683544303798,0,0.0,7.482199615
Au,79,143,222,1.8101265822784811,0,-1.0,7.458850288
Au,79,144,223,1.8227848101265822,0,0.0,7.442264574
Au,79,145,224,1.8354430379746836,0,-1.0,7.418509188
Au,79,146,225,1.8481012658227849,0,0.0,7.401481204
Au,79,147,226,1.860759493670886,0,-1.0,7.377047327
Au,79,148,227,1.8734177215189873,0,0.0,7.359296396
Au,79,149,228,1.8860759493670887,0,-1.0,7.334044022
Au,79,150,229,1.8987341772151898,0,0.0,7.315369393
Au,79,151,230,1.9113924050632911,0,-1.0,7.289528274
Au,79,152,231,1.9240506329113924,0,0.0,7.270053147
Au,79,153,232,1.9367088607594938,0,-1.0,7.244157065
Au,79,154,233,1.9493670886075949,0,0.0,7.224405442
Au,79,155,234,1.9620253164556962,0,-1.0,7.19872412
Au,79,156,235,1.9746835443037976,0,0.0,7.179143217
Au,79,157,236,1.9873417721518987,0,-1.0,7.15296236
Au,79,158,237,2.0,0,0.0,7.133001511
Au,79,159,238,2.0126582278481013,0,-1.0,7.105912122
Au,79,160,239,2.0253164556962027,0,0.0,7.085047247
Au,79,161,240,2.037974683544304,0,-1.0,7.057446125
Au,79,162,241,2.050632911392405,0,0.0,7.035880568
Au,79,163,242,2.0632911392405062,0,-1.0,7.007963393
Au,79,164,243,2.0759493670886076,0,0.0,6.986194461
Au,79,165,244,2.088607594936709,0,-1.0,6.959467762
Au,79,166,245,2.1012658227848102,0,0.0,6.939039788
Au,79,167,246,2.1139240506329116,0,-1.0,6.912553236
Au,79,168,247,2.1265822784810124,0,0.0,6.892258559
Au,79,169,248,2.1392405063291138,0,-1.0,6.865838133
Au,79,170,249,2.151898734177215,0,0.0,6.845529695
Au,79,171,250,2.1645569620253164,0,-1.0,6.819126652
Au,79,172,251,2.1772151898734178,0,0.0,6.798736239
Au,79,173,252,2.189873417721519,0,-1.0,6.773012321
Au,79,174,253,2.2025316455696204,0,0.0,6.753236482
Au,79,175,254,2.2151898734177213,0,-1.0,6.727905858
Au,79,176,255,2.2278481012658227,0,0.0,6.708436518
Au,79,177,256,2.240506329113924,0,-1.0,6.68267173
Au,79,178,257,2.2531645569620253,0,0.0,6.662513518
Au,79,179,258,2.2658227848101267,0,-1.0,6.636829054
Au,79,180,259,2.278481012658228,0,0.0,6.616534444
Au,79,181,260,2.2911392405063293,0,-1.0,6.591722969
Au,79,182,261,2.3037974683544302,0,0.0,6.572361276
Au,79,184,263,2.329113924050633,0,0.0,6.527474875
Hg,80,93,173,1.1625,0,0.0,7.705693364
Hg,80,94,174,1.175,0,1.0,7.726759626
Hg,80,95,175,1.1875,0,0.0,7.734335817
Hg,80,96,176,1.2,0,1.0,7.75345458
Hg,80,97,177,1.2125,0,0.0,7.761568418
Hg,80,98,178,1.225,0,1.0,7.779898365
Hg,80,99,179,1.2375,0,0.0,7.788329425
Hg,80,100,180,1.25,0,1.0,7.8054963
Hg,80,101,181,1.2625,0,0.0,7.811417801
Hg,80,102,182,1.275,0,1.0,7.82582478
Hg,80,103,183,1.2875,0,0.0,7.829233514
Hg,80,104,184,1.3,0,1.0,7.841856288
Hg,80,105,185,1.3125,0,0.0,7.843433357
Hg,80,106,186,1.325,0,1.0,7.85495136
Hg,80,107,187,1.3375,0,0.0,7.854875075
Hg,80,108,188,1.35,0,1.0,7.864514979
Hg,80,109,189,1.3625,0,0.0,7.863521651
Hg,80,110,190,1.375,0,1.0,7.872071811
Hg,80,111,191,1.3875,0,0.0,7.870169639
Hg,80,112,192,1.4,0,1.0,7.877579526
Hg,80,113,193,1.4125,0,0.0,7.87458815
Hg,80,114,194,1.425,0,1.0,7.880538423
Hg,80,115,195,1.4375,0,0.0,7.876266236
Hg,80,116,196,1.45,0,1.0,7.880516454
Hg,80,117,197,1.4625,0,0.0,7.874782376
Hg,80,118,198,1.475,0,1.0,7.877205924
Hg,80,119,199,1.4875,0,0.0,7.87099396
Hg,80,120,200,1.5,0,1.0,7.87263415
Hg,80,121,201,1.5125,0,0.0,7.866815562
Hg,80,122,202,1.525,0,1.0,7.868663109
Hg,80,123,203,1.5375,0,0.0,7.861610384
Hg,80,124,204,1.55,0,1.0,7.862316299
Hg,80,125,205,1.5625,0,0.0,7.853306229
Hg,80,126,206,1.575,1,1.0,7.854356641
Hg,80,127,207,1.5875,0,0.0,7.828548643
Hg,80,128,208,1.6,0,1.0,7.812087202
Hg,80,129,209,1.6125,0,0.0,7.78625299
Hg,80,130,210,1.625,0,1.0,7.767109929
Hg,80,131,211,1.6375,0,0.0,7.740951777
Hg,80,132,212,1.65,0,1.0,7.722187193
Hg,80,133,213,1.6625,0,0.0,7.695527103
Hg,80,134,214,1.675,0,1.0,7.676981248
Hg,80,135,215,1.6875,0,0.0,7.649609856
Hg,80,136,216,1.7,0,1.0,7.630985389
Hg,80,137,217,1.7125,0,0.0,7.603633912
Hg,80,138,218,1.725,0,1.0,7.585219248
Hg,80,139,219,1.7375,0,0.0,7.559477041
Hg,80,140,220,1.75,0,1.0,7.541647409
Hg,80,141,221,1.7625,0,0.0,7.519117891
Hg,80,142,222,1.775,0,1.0,7.503456568
Hg,80,143,223,1.7875,0,0.0,7.480708547
Hg,80,144,224,1.8,0,1.0,7.464694884
Hg,80,145,225,1.8125,0,0.0,7.441719084
Hg,80,146,226,1.825,0,1.0,7.425415478
Hg,80,147,227,1.8375,0,0.0,7.40192293
Hg,80,148,228,1.85,0,1.0,7.385049061
Hg,80,149,229,1.8625,0,0.0,7.360755105
Hg,80,150,230,1.875,0,1.0,7.342985057
Hg,80,151,231,1.8875,0,0.0,7.318013411
Hg,80,152,232,1.9,0,1.0,7.299352185
Hg,80,153,233,1.9125,0,0.0,7.274241888
Hg,80,154,234,1.925,0,1.0,7.255209778
Hg,80,155,235,1.9375,0,0.0,7.230259294
Hg,80,156,236,1.95,0,1.0,7.211339178
Hg,80,157,237,1.9625,0,0.0,7.185841384
Hg,80,158,238,1.975,0,1.0,7.166494887
Hg,80,159,239,1.9875,0,0.0,7.140021946
Hg,80,160,240,2.0,0,1.0,7.119725642
Hg,80,161,241,2.0125,0,0.0,7.09262932
Hg,80,162,242,2.025,0,1.0,7.071544252
Hg,80,163,243,2.0375,0,0.0,7.044001066
Hg,80,164,244,2.05,0,1.0,7.022927713
Hg,80,165,245,2.0625,0,0.0,6.997341298
Hg,80,166,246,2.075,0,1.0,6.978661541
Hg,80,167,247,2.0875,0,0.0,6.952901684
Hg,80,168,248,2.1,0,1.0,6.933826593
Hg,80,169,249,2.1125,0,0.0,6.908100418
Hg,80,170,250,2.125,0,1.0,6.888838404
Hg,80,171,251,2.1375,0,0.0,6.863475737
Hg,80,172,252,2.15,0,1.0,6.844370968
Hg,80,173,253,2.1625,0,0.0,6.819501138
Hg,80,174,254,2.175,0,1.0,6.800690543
Hg,80,175,255,2.1875,0,0.0,6.776027612
Hg,80,176,256,2.2,0,1.0,6.757246586
Hg,80,177,257,2.2125,0,0.0,6.732123914
Hg,80,178,258,2.225,0,1.0,6.712645035
Hg,80,179,259,2.2375,0,0.0,6.68765761
Hg,80,180,260,2.25,0,1.0,6.668099304
Hg,80,181,261,2.2625,0,0.0,6.644566927
Hg,80,182,262,2.275,0,1.0,6.626425683
Hg,80,184,264,2.3,0,1.0,6.582308462
Tl,81,96,177,1.1851851851851851,0,0.0,7.707294655
Tl,81,98,179,1.2098765432098766,0,0.0,7.735516391
Tl,81,100,181,1.2345679012345678,0,0.0,7.762050956
Tl,81,102,183,1.2592592592592593,0,0.0,7.783846869
Tl,81,103,184,1.271604938271605,0,-1.0,7.788988886
Tl,81,104,185,1.2839506172839505,0,0.0,7.804275524
Tl,81,105,186,1.2962962962962963,0,-1.0,7.807564688
Tl,81,106,187,1.308641975308642,0,0.0,7.820585433
Tl,81,107,188,1.3209876543209877,0,-1.0,7.821848479
Tl,81,108,189,1.3333333333333333,0,0.0,7.83260245
Tl,81,109,190,1.345679012345679,0,-1.0,7.832668874
Tl,81,110,191,1.3580246913580247,0,0.0,7.842031984
Tl,81,111,192,1.3703703703703705,0,-1.0,7.840356344
Tl,81,112,193,1.382716049382716,0,0.0,7.848302326
Tl,81,113,194,1.3950617283950617,0,-1.0,7.846520546
Tl,81,114,195,1.4074074074074074,0,0.0,7.854508677
Tl,81,115,196,1.4197530864197532,0,-1.0,7.851718587
Tl,81,116,197,1.4320987654320987,0,0.0,7.858267614
Tl,81,117,198,1.4444444444444444,0,-1.0,7.854471187
Tl,81,118,199,1.4567901234567902,0,0.0,7.859695246
Tl,81,119,200,1.4691358024691359,0,-1.0,7.855768225
Tl,81,120,201,1.4814814814814814,0,0.0,7.860501383
Tl,81,121,202,1.4938271604938271,0,-1.0,7.8566685
Tl,81,122,203,1.5061728395061729,0,0.0,7.861004759
Tl,81,123,204,1.5185185185185186,0,-1.0,7.856263598
Tl,81,124,205,1.5308641975308641,0,0.0,7.859380234
Tl,81,125,206,1.5432098765432098,0,-1.0,7.851503456
Tl,81,126,207,1.5555555555555556,1,0.0,7.853611585
Tl,81,127,208,1.5679012345679013,0,-1.0,7.828949221
Tl,81,128,209,1.5802469135802468,0,0.0,7.813606713
Tl,81,129,210,1.5925925925925926,0,-1.0,7.788844671
Tl,81,130,211,1.6049382716049383,0,0.0,7.770800265
Tl,81,131,212,1.617283950617284,0,-1.0,7.74566658
Tl,81,132,213,1.6296296296296295,0,0.0,7.727952981
Tl,81,133,214,1.6419753086419753,0,-1.0,7.702287266
Tl,81,134,215,1.654320987654321,0,0.0,7.684742516
Tl,81,135,216,1.6666666666666667,0,-1.0,7.658413954
Tl,81,136,217,1.6790123456790123,0,0.0,7.640815963
Tl,81,137,218,1.691358024691358,0,-1.0,7.614352972
Tl,81,138,219,1.7037037037037037,0,0.0,7.596962078
Tl,81,139,220,1.7160493827160495,0,-1.0,7.570916405
Tl,81,140,221,1.728395061728395,0,0.0,7.553637158
Tl,81,141,222,1.7407407407407407,0,-1.0,7.530858405
Tl,81,142,223,1.7530864197530864,0,0.0,7.515660543
Tl,81,143,224,1.7654320987654322,0,-1.0,7.49343629
Tl,81,144,225,1.7777777777777777,0,0.0,7.477944809
Tl,81,145,226,1.7901234567901234,0,-1.0,7.455701819
Tl,81,146,227,1.8024691358024691,0,0.0,7.440087476
Tl,81,147,228,1.8148148148148149,0,-1.0,7.417446101
Tl,81,148,229,1.8271604938271604,0,0.0,7.401362651
Tl,81,149,230,1.8395061728395061,0,-1.0,7.377916926
Tl,81,150,231,1.8518518518518519,0,0.0,7.360941528
Tl,81,151,232,1.8641975308641976,0,-1.0,7.336737272
Tl,81,152,233,1.876543209876543,0,0.0,7.318797382
Tl,81,153,234,1.8888888888888888,0,-1.0,7.294400726
Tl,81,154,235,1.9012345679012346,0,0.0,7.276036128
Tl,81,155,236,1.9135802469135803,0,-1.0,7.25178222
Tl,81,156,237,1.9259259259259258,0,0.0,7.233510802
Tl,81,157,238,1.9382716049382716,0,-1.0,7.208757294
Tl,81,158,239,1.9506172839506173,0,0.0,7.190099117
Tl,81,159,240,1.962962962962963,0,-1.0,7.164469042
Tl,81,160,241,1.9753086419753085,0,0.0,7.144970456
Tl,81,161,242,1.9876543209876543,0,-1.0,7.118688595
Tl,81,162,243,2.0,0,0.0,7.098400313
Tl,81,163,244,2.0123456790123457,0,-1.0,7.07241766
Tl,81,164,245,2.0246913580246915,0,0.0,7.052849976
Tl,81,165,246,2.037037037037037,0,-1.0,7.027926679
Tl,81,166,247,2.049382716049383,0,0.0,7.009814336
Tl,81,167,248,2.0617283950617282,0,-1.0,6.984701101
Tl,81,168,249,2.074074074074074,0,0.0,6.966168518
Tl,81,169,250,2.0864197530864197,0,-1.0,6.940941896
Tl,81,170,251,2.0987654320987654,0,0.0,6.92207039
Tl,81,171,252,2.111111111111111,0,-1.0,6.896851718
Tl,81,172,253,2.123456790123457,0,0.0,6.877914447
Tl,81,173,254,2.1358024691358026,0,-1.0,6.853883161
Tl,81,174,255,2.1481481481481484,0,0.0,6.836088169
Tl,81,175,256,2.1604938271604937,0,-1.0,6.812270371
Tl,81,176,257,2.1728395061728394,0,0.0,6.79452121
Tl,81,177,258,2.185185185185185,0,-1.0,6.770551198
Tl,81,178,259,2.197530864197531,0,0.0,6.752425861
Tl,81,179,260,2.2098765432098766,0,-1.0,6.728831435
Tl,81,180,261,2.2222222222222223,0,0.0,6.71077113
Tl,81,181,262,2.234567901234568,0,-1.0,6.68796592
Tl,81,182,263,2.246913580246914,0,0.0,6.670497608
Tl,81,183,264,2.259259259259259,0,-1.0,6.64562203
Tl,81,184,265,2.271604938271605,0,0.0,6.627242781
Pb,82,96,178,1.170731707317073,1,1.0,7.67233864
Pb,82,97,179,1.1829268292682926,1,0.0,7.681303793
Pb,82,98,180,1.1951219512195121,1,1.0,7.703043172
Pb,82,99,181,1.2073170731707317,1,0.0,7.710363541
Pb,82,100,182,1.2195121951219512,1,1.0,7.730373242
Pb,82,101,183,1.2317073170731707,1,0.0,7.735596798
Pb,82,102,184,1.2439024390243902,1,1.0,7.753421136
Pb,82,103,185,1.2560975609756098,1,0.0,7.758632632
Pb,82,104,186,1.2682926829268293,1,1.0,7.77492722
Pb,82,105,187,1.2804878048780488,1,0.0,7.779858866
Pb,82,106,188,1.2926829268292683,1,1.0,7.794315707
Pb,82,107,189,1.3048780487804879,1,0.0,7.796908397
Pb,82,108,190,1.3170731707317074,1,1.0,7.808769226
Pb,82,109,191,1.329268292682927,1,0.0,7.80989222
Pb,82,110,192,1.3414634146341464,1,1.0,7.820067698
Pb,82,111,193,1.353658536585366,1,0.0,7.819481891
Pb,82,112,194,1.3658536585365855,1,1.0,7.828815191
Pb,82,113,195,1.3780487804878048,1,0.0,7.828248354
Pb,82,114,196,1.3902439024390243,1,1.0,7.838271189
Pb,82,115,197,1.4024390243902438,1,0.0,7.837037964
Pb,82,116,198,1.4146341463414633,1,1.0,7.845951566
Pb,82,117,199,1.4268292682926829,1,0.0,7.844151563
Pb,82,118,200,1.4390243902439024,1,1.0,7.852225705
Pb,82,119,201,1.451219512195122,1,0.0,7.85030806
Pb,82,120,202,1.4634146341463414,1,1.0,7.857853347
Pb,82,121,203,1.475609756097561,1,0.0,7.855766187
Pb,82,122,204,1.4878048780487805,1,1.0,7.862348598
Pb,82,123,205,1.5,1,0.0,7.859920707
Pb,82,124,206,1.5121951219512195,1,1.0,7.865448786
Pb,82,125,207,1.524390243902439,1,0.0,7.858635285
Pb,82,126,208,1.5365853658536586,1,1.0,7.86173251
Pb,82,127,209,1.548780487804878,1,0.0,7.838143478
Pb,82,128,210,1.5609756097560976,1,1.0,7.823848543
Pb,82,129,211,1.5731707317073171,1,0.0,7.800074498
Pb,82,130,212,1.5853658536585367,1,1.0,7.783045113
Pb,82,131,213,1.5975609756097562,1,0.0,7.75885092
Pb,82,132,214,1.6097560975609757,1,1.0,7.742103879
Pb,82,133,215,1.6219512195121952,1,0.0,7.717347674
Pb,82,134,216,1.6341463414634145,1,1.0,7.70071988
Pb,82,135,217,1.646341463414634,1,0.0,7.675345576
Pb,82,136,218,1.6585365853658536,1,1.0,7.658686463
Pb,82,137,219,1.670731707317073,1,0.0,7.632781091
Pb,82,138,220,1.6829268292682926,1,1.0,7.616084886
Pb,82,139,221,1.6951219512195121,1,0.0,7.589856041
Pb,82,140,222,1.7073170731707317,1,1.0,7.573238712
Pb,82,141,223,1.7195121951219512,1,0.0,7.549017072
Pb,82,142,224,1.7317073170731707,1,1.0,7.533093313
Pb,82,143,225,1.7439024390243902,1,0.0,7.511425876
Pb,82,144,226,1.7560975609756098,1,1.0,7.496489336
Pb,82,145,227,1.7682926829268293,1,0.0,7.475004485
Pb,82,146,228,1.7804878048780488,1,1.0,7.46010489
Pb,82,147,229,1.7926829268292683,1,0.0,7.438301153
Pb,82,148,230,1.8048780487804879,1,1.0,7.42299523
Pb,82,149,231,1.8170731707317074,1,0.0,7.40036726
Pb,82,150,232,1.829268292682927,1,1.0,7.384156759
Pb,82,151,233,1.8414634146341464,1,0.0,7.360692206
Pb,82,152,234,1.853658536585366,1,1.0,7.343446594
Pb,82,153,235,1.8658536585365855,1,0.0,7.319739745
Pb,82,154,236,1.8780487804878048,1,1.0,7.302019419
Pb,82,155,237,1.8902439024390243,1,0.0,7.278437954
Pb,82,156,238,1.9024390243902438,1,1.0,7.260791697
Pb,82,157,239,1.9146341463414633,1,0.0,7.236747958
Pb,82,158,240,1.9268292682926829,1,1.0,7.218744337
Pb,82,159,241,1.9390243902439024,1,0.0,7.193905502
Pb,82,160,242,1.951219512195122,1,1.0,7.175153802
Pb,82,161,243,1.9634146341463414,1,0.0,7.149626321
Pb,82,162,244,1.975609756097561,1,1.0,7.130075373
Pb,82,163,245,1.9878048780487805,1,0.0,7.10576222
Pb,82,164,246,2.0,1,1.0,7.087808736
Pb,82,165,247,2.0121951219512195,1,0.0,7.063526105
Pb,82,166,248,2.024390243902439,1,1.0,7.045959681
Pb,82,167,249,2.0365853658536586,1,0.0,7.021476205
Pb,82,168,250,2.048780487804878,1,1.0,7.003470236
Pb,82,169,251,2.0609756097560976,1,0.0,6.978700267
Pb,82,170,252,2.073170731707317,1,1.0,6.960177575
Pb,82,171,253,2.0853658536585367,1,0.0,6.935244383
Pb,82,172,254,2.097560975609756,1,1.0,6.916614799
Pb,82,173,255,2.1097560975609757,1,0.0,6.893227357
Pb,82,174,256,2.1219512195121952,1,1.0,6.876253406
Pb,82,175,257,2.1341463414634148,1,0.0,6.853514093
Pb,82,176,258,2.1463414634146343,1,1.0,6.837026891
Pb,82,177,259,2.158536585365854,1,0.0,6.814362332
Pb,82,178,260,2.1707317073170733,1,1.0,6.7977406
Pb,82,179,261,2.182926829268293,1,0.0,6.775458295
Pb,82,180,262,2.1951219512195124,1,1.0,6.758814939
Pb,82,181,263,2.207317073170732,1,0.0,6.736754521
Pb,82,182,264,2.2195121951219514,1,1.0,6.719977053
Pb,82,183,265,2.231707317073171,1,0.0,6.695549528
Pb,82,184,266,2.2439024390243905,1,1.0,6.67754818
Bi,83,100,183,1.2048192771084338,0,0.0,7.678341033
Bi,83,102,185,1.2289156626506024,0,0.0,7.705866578
Bi,83,104,187,1.2530120481927711,0,0.0,7.731869203
Bi,83,105,188,1.2650602409638554,0,-1.0,7.738514495
Bi,83,106,189,1.2771084337349397,0,0.0,7.754471011
Bi,83,107,190,1.2891566265060241,0,-1.0,7.758478989
Bi,83,108,191,1.3012048192771084,0,0.0,7.771543162
Bi,83,109,192,1.3132530120481927,0,-1.0,7.773729594
Bi,83,110,193,1.3253012048192772,0,0.0,7.784734596
Bi,83,111,194,1.3373493975903614,0,-1.0,7.78514182
Bi,83,112,195,1.3493975903614457,0,0.0,7.794734236
Bi,83,113,196,1.3614457831325302,0,-1.0,7.795708388
Bi,83,114,197,1.3734939759036144,0,0.0,7.806422223
Bi,83,115,198,1.3855421686746987,0,-1.0,7.806423263
Bi,83,116,199,1.3975903614457832,0,0.0,7.816081769
Bi,83,117,200,1.4096385542168675,0,-1.0,7.815317045
Bi,83,118,201,1.4216867469879517,0,0.0,7.823852328
Bi,83,119,202,1.4337349397590362,0,-1.0,7.822863609
Bi,83,120,203,1.4457831325301205,0,0.0,7.830751443
Bi,83,121,204,1.4578313253012047,0,-1.0,7.829536853
Bi,83,122,205,1.4698795180722892,0,0.0,7.836599273
Bi,83,123,206,1.4819277108433735,0,-1.0,7.835138655
Bi,83,124,207,1.4939759036144578,0,0.0,7.841471464
Bi,83,125,208,1.5060240963855422,0,-1.0,7.835854264
Bi,83,126,209,1.5180722891566265,1,0.0,7.840069828
Bi,83,127,210,1.5301204819277108,0,-1.0,7.817745914
Bi,83,128,211,1.5421686746987953,0,0.0,7.804687953
Bi,83,129,212,1.5542168674698795,0,-1.0,7.782093443
Bi,83,130,213,1.5662650602409638,0,0.0,7.766279042
Bi,83,131,214,1.5783132530120483,0,-1.0,7.74369685
Bi,83,132,215,1.5903614457831325,0,0.0,7.728458558
Bi,83,133,216,1.6024096385542168,0,-1.0,7.706087912
Bi,83,134,217,1.6144578313253013,0,0.0,7.691433839
Bi,83,135,218,1.6265060240963856,0,-1.0,7.668387372
Bi,83,136,219,1.6385542168674698,0,0.0,7.653379785
Bi,83,137,220,1.6506024096385543,0,-1.0,7.630086736
Bi,83,138,221,1.6626506024096386,0,0.0,7.615071222
Bi,83,139,222,1.6746987951807228,0,-1.0,7.591872838
Bi,83,140,223,1.6867469879518073,0,0.0,7.577041543
Bi,83,141,224,1.6987951807228916,0,-1.0,7.555385446
Bi,83,142,225,1.7108433734939759,0,0.0,7.541312671
Bi,83,143,226,1.7228915662650603,0,-1.0,7.520372261
Bi,83,144,227,1.7349397590361446,0,0.0,7.506132925
Bi,83,145,228,1.7469879518072289,0,-1.0,7.485392855
Bi,83,146,229,1.7590361445783131,0,0.0,7.471190852
Bi,83,147,230,1.7710843373493976,0,-1.0,7.450145617
Bi,83,148,231,1.783132530120482,0,0.0,7.435547723
Bi,83,149,232,1.7951807228915662,0,-1.0,7.413655017
Bi,83,150,233,1.8072289156626506,0,0.0,7.398139717
Bi,83,151,234,1.819277108433735,0,-1.0,7.375370863
Bi,83,152,235,1.8313253012048192,0,0.0,7.358798281
Bi,83,153,236,1.8433734939759037,0,-1.0,7.335749085
Bi,83,154,237,1.855421686746988,0,0.0,7.318675759
Bi,83,155,238,1.8674698795180722,0,-1.0,7.295750013
Bi,83,156,239,1.8795180722891567,0,0.0,7.278744142
Bi,83,157,240,1.891566265060241,0,-1.0,7.255452104
Bi,83,158,241,1.9036144578313252,0,0.0,7.238169228
Bi,83,159,242,1.9156626506024097,0,-1.0,7.214219351
Bi,83,160,243,1.927710843373494,0,0.0,7.196328494
Bi,83,161,244,1.9397590361445782,0,-1.0,7.171717152
Bi,83,162,245,1.9518072289156627,0,0.0,7.153077527
Bi,83,163,246,1.963855421686747,0,-1.0,7.128672764
Bi,83,164,247,1.9759036144578312,0,0.0,7.110588798
Bi,83,165,248,1.9879518072289157,0,-1.0,7.087026137
Bi,83,166,249,2.0,0,0.0,7.070086024
Bi,83,167,250,2.0120481927710845,0,-1.0,7.046343244
Bi,83,168,251,2.0240963855421685,0,0.0,7.029005554
Bi,83,169,252,2.036144578313253,0,-1.0,7.005061004
Bi,83,170,253,2.0481927710843375,0,0.0,6.987350498
Bi,83,171,254,2.0602409638554215,0,-1.0,6.963475205
Bi,83,172,255,2.072289156626506,0,0.0,6.94587478
Bi,83,173,256,2.0843373493975905,0,-1.0,6.923232703
Bi,83,174,257,2.0963855421686746,0,0.0,6.906900603
Bi,83,175,258,2.108433734939759,0,-1.0,6.884388492
Bi,83,176,259,2.1204819277108435,0,0.0,6.867981317
Bi,83,177,260,2.1325301204819276,0,-1.0,6.845430108
Bi,83,178,261,2.144578313253012,0,0.0,6.828701502
Bi,83,179,262,2.1566265060240966,0,-1.0,6.806412977
Bi,83,180,263,2.1686746987951806,0,0.0,6.789573962
Bi,83,181,264,2.180722891566265,0,-1.0,6.767959992
Bi,83,182,265,2.1927710843373496,0,0.0,6.751494491
Bi,83,183,266,2.2048192771084336,0,-1.0,6.727557598
Bi,83,184,267,2.216867469879518,0,0.0,6.709945375
Po,84,101,185,1.2023809523809523,0,0.0,7.649897465
Po,84,103,187,1.2261904761904763,0,0.0,7.678882829
Po,84,104,188,1.2380952380952381,0,1.0,7.696536649
Po,84,105,189,1.25,0,0.0,7.704821725
Po,84,106,190,1.2619047619047619,0,1.0,7.722207089
Po,84,107,191,1.2738095238095237,0,0.0,7.727543576
Po,84,108,192,1.2857142857142858,0,1.0,7.741727432
Po,84,109,193,1.2976190476190477,0,0.0,7.744900119
Po,84,110,194,1.3095238095238095,0,1.0,7.75666068
Po,84,111,195,1.3214285714285714,0,0.0,7.758852585
Po,84,112,196,1.3333333333333333,0,1.0,7.769495179
Po,84,113,197,1.3452380952380953,0,0.0,7.771919396
Po,84,114,198,1.3571428571428572,0,1.0,7.783242813
Po,84,115,199,1.369047619047619,0,0.0,7.78451207
Po,84,116,200,1.380952380952381,0,1.0,7.794954005
Po,84,117,201,1.3928571428571428,0,0.0,7.795390244
Po,84,118,202,1.4047619047619047,0,1.0,7.804556401
Po,84,119,203,1.4166666666666667,0,0.0,7.804498448
Po,84,120,204,1.4285714285714286,0,1.0,7.812736407
Po,84,121,205,1.4404761904761905,0,0.0,7.81232542
Po,84,122,206,1.4523809523809523,0,1.0,7.819803374
Po,84,123,207,1.4642857142857142,0,0.0,7.81926585
Po,84,124,208,1.4761904761904763,0,1.0,7.826361197
Po,84,125,209,1.4880952380952381,0,0.0,7.82186267
Po,84,126,210,1.5,1,1.0,7.827120438
Po,84,127,211,1.5119047619047619,0,0.0,7.805990749
Po,84,128,212,1.5238095238095237,0,1.0,7.794099797
Po,84,129,213,1.5357142857142858,0,0.0,7.77260408
Po,84,130,214,1.5476190476190477,0,1.0,7.757924332
Po,84,131,215,1.5595238095238095,0,0.0,7.736761023
Po,84,132,216,1.5714285714285714,0,1.0,7.722841102
Po,84,133,217,1.5833333333333333,0,0.0,7.702809484
Po,84,134,218,1.5952380952380953,0,1.0,7.690086798
Po,84,135,219,1.6071428571428572,0,0.0,7.669390543
Po,84,136,220,1.619047619047619,0,1.0,7.656062809
Po,84,137,221,1.630952380952381,0,0.0,7.635458837
Po,84,138,222,1.6428571428571428,0,1.0,7.622208473
Po,84,139,223,1.6547619047619047,0,0.0,7.601880525
Po,84,140,224,1.6666666666666667,0,1.0,7.58868779
Po,84,141,225,1.6785714285714286,0,0.0,7.568296329
Po,84,142,226,1.6904761904761905,0,1.0,7.554791456
Po,84,143,227,1.7023809523809523,0,0.0,7.534569203
Po,84,144,228,1.7142857142857142,0,1.0,7.521018539
Po,84,145,229,1.7261904761904763,0,0.0,7.501051393
Po,84,146,230,1.7380952380952381,0,1.0,7.487575283
Po,84,147,231,1.75,0,0.0,7.467270528
Po,84,148,232,1.7619047619047619,0,1.0,7.453363211
Po,84,149,233,1.7738095238095237,0,0.0,7.432167365
Po,84,150,234,1.7857142857142858,0,1.0,7.417309534
Po,84,151,235,1.7976190476190477,0,0.0,7.395204838
Po,84,152,236,1.8095238095238095,0,1.0,7.379274203
Po,84,153,237,1.8214285714285714,0,0.0,7.356858105
Po,84,154,238,1.8333333333333333,0,1.0,7.340407504
Po,84,155,239,1.8452380952380953,0,0.0,7.318114243
Po,84,156,240,1.8571428571428572,0,1.0,7.301725833
Po,84,157,241,1.869047619047619,0,0.0,7.279161216
Po,84,158,242,1.880952380952381,0,1.0,7.26257526
Po,84,159,243,1.8928571428571428,0,0.0,7.239482712
Po,84,160,244,1.9047619047619047,0,1.0,7.222421557
Po,84,161,245,1.9166666666666667,0,0.0,7.198688735
Po,84,162,246,1.9285714285714286,0,1.0,7.180923146
Po,84,163,247,1.9404761904761905,0,0.0,7.156493964
Po,84,164,248,1.9523809523809523,0,1.0,7.138346484
Po,84,165,249,1.9642857142857142,0,0.0,7.115455197
Po,84,166,250,1.9761904761904763,0,1.0,7.099093944
Po,84,167,251,1.9880952380952381,0,0.0,7.075997195
Po,84,168,252,2.0,0,1.0,7.059234448
Po,84,169,253,2.011904761904762,0,0.0,7.035953356
Po,84,170,254,2.0238095238095237,0,1.0,7.018894461
Po,84,171,255,2.0357142857142856,0,0.0,6.996219188
Po,84,172,256,2.0476190476190474,0,1.0,6.979789156
Po,84,173,257,2.0595238095238093,0,0.0,6.957661195
Po,84,174,258,2.0714285714285716,0,1.0,6.941742302
Po,84,175,259,2.0833333333333335,0,0.0,6.919669799
Po,84,176,260,2.0952380952380953,0,1.0,6.903554554
Po,84,177,261,2.107142857142857,0,0.0,6.881355529
Po,84,178,262,2.119047619047619,0,1.0,6.864758737
Po,84,179,263,2.130952380952381,0,0.0,6.842444099
Po,84,180,264,2.142857142857143,0,1.0,6.825391114
Po,84,181,265,2.1547619047619047,0,0.0,6.804209808
Po,84,182,266,2.1666666666666665,0,1.0,6.788043598
Po,84,183,267,2.1785714285714284,0,0.0,6.76457779
Po,84,184,268,2.1904761904761907,0,1.0,6.747336056
At,85,104,189,1.223529411764706,0,0.0,7.65096245
At,85,106,191,1.2470588235294118,0,0.0,7.677577691
At,85,108,193,1.2705882352941176,0,0.0,7.69999028
At,85,110,195,1.2941176470588236,0,0.0,7.716978236
At,85,111,196,1.3058823529411765,0,-1.0,7.720644418
At,85,112,197,1.3176470588235294,0,0.0,7.732769376
At,85,113,198,1.3294117647058823,0,-1.0,7.73626401
At,85,114,199,1.3411764705882352,0,0.0,7.748521518
At,85,115,200,1.3529411764705883,0,-1.0,7.75100119
At,85,116,201,1.3647058823529412,0,0.0,7.762248075
At,85,117,202,1.3764705882352941,0,-1.0,7.763959644
At,85,118,203,1.388235294117647,0,0.0,7.774050251
At,85,119,204,1.4,0,-1.0,7.774973833
At,85,120,205,1.411764705882353,0,0.0,7.783841146
At,85,121,206,1.423529411764706,0,-1.0,7.784455092
At,85,122,207,1.4352941176470588,0,0.0,7.792662082
At,85,123,208,1.4470588235294117,0,-1.0,7.792589471
At,85,124,209,1.4588235294117646,0,0.0,7.799982861
At,85,125,210,1.4705882352941178,0,-1.0,7.796683
At,85,126,211,1.4823529411764707,1,0.0,7.803040934
At,85,127,212,1.4941176470588236,0,-1.0,7.783162443
At,85,128,213,1.5058823529411764,0,0.0,7.772494502
At,85,129,214,1.5176470588235293,0,-1.0,7.753111159
At,85,130,215,1.5294117647058822,0,0.0,7.740335995
At,85,131,216,1.5411764705882354,0,-1.0,7.722159542
At,85,132,217,1.5529411764705883,0,0.0,7.71077488
At,85,133,218,1.5647058823529412,0,-1.0,7.692593991
At,85,134,219,1.576470588235294,0,0.0,7.681305119
At,85,135,220,1.588235294117647,0,-1.0,7.662493132
At,85,136,221,1.6,0,0.0,7.650642833
At,85,137,222,1.611764705882353,0,-1.0,7.63186014
At,85,138,223,1.6235294117647059,0,0.0,7.62005322
At,85,139,224,1.6352941176470588,0,-1.0,7.601393594
At,85,140,225,1.6470588235294117,0,0.0,7.589606324
At,85,141,226,1.6588235294117648,0,-1.0,7.570669372
At,85,142,227,1.6705882352941177,0,0.0,7.558452771
At,85,143,228,1.6823529411764706,0,-1.0,7.53938711
At,85,144,229,1.6941176470588235,0,0.0,7.52687724
At,85,145,230,1.7058823529411764,0,-1.0,7.507782526
At,85,146,231,1.7176470588235293,0,0.0,7.495097987
At,85,147,232,1.7294117647058824,0,-1.0,7.475551022
At,85,148,233,1.7411764705882353,0,0.0,7.4623423
At,85,149,234,1.7529411764705882,0,-1.0,7.44186706
At,85,150,235,1.7647058823529411,0,0.0,7.427693038
At,85,151,236,1.776470588235294,0,-1.0,7.406268072
At,85,152,237,1.7882352941176471,0,0.0,7.391001553
At,85,153,238,1.8,0,-1.0,7.369250328
At,85,154,239,1.811764705882353,0,0.0,7.353464523
At,85,155,240,1.8235294117647058,0,-1.0,7.3318404
At,85,156,241,1.8352941176470587,0,0.0,7.316122938
At,85,157,242,1.8470588235294119,0,-1.0,7.294316244
At,85,158,243,1.8588235294117648,0,0.0,7.278469774
At,85,159,244,1.8705882352941177,0,-1.0,7.256261967
At,85,160,245,1.8823529411764706,0,0.0,7.240059506
At,85,161,246,1.8941176470588235,0,-1.0,7.217250236
At,85,162,247,1.9058823529411764,0,0.0,7.200399899
At,85,163,248,1.9176470588235295,0,-1.0,7.177015004
At,85,164,249,1.9294117647058824,0,0.0,7.159709514
At,85,165,250,1.9411764705882353,0,-1.0,7.137135788
At,85,166,251,1.9529411764705882,0,0.0,7.120781462
At,85,167,252,1.964705882352941,0,-1.0,7.098295214
At,85,168,253,1.9764705882352942,0,0.0,7.081973838
At,85,169,254,1.988235294117647,0,-1.0,7.059528272
At,85,170,255,2.0,0,0.0,7.043174584
At,85,171,256,2.011764705882353,0,-1.0,7.020990402
At,85,172,257,2.023529411764706,0,0.0,7.004830529
At,85,173,258,2.0352941176470587,0,-1.0,6.983178519
At,85,174,259,2.0470588235294116,0,0.0,6.967500641
At,85,175,260,2.0588235294117645,0,-1.0,6.946115735
At,85,176,261,2.070588235294118,0,0.0,6.930535391
At,85,177,262,2.0823529411764707,0,-1.0,6.908845878
At,85,178,263,2.0941176470588236,0,0.0,6.892629658
At,85,179,264,2.1058823529411765,0,-1.0,6.870738848
At,85,180,265,2.1176470588235294,0,0.0,6.853970298
At,85,181,266,2.1294117647058823,0,-1.0,6.832879214
At,85,182,267,2.1411764705882352,0,0.0,6.816658618
At,85,183,268,2.152941176470588,0,-1.0,6.793677597
At,85,184,269,2.164705882352941,0,0.0,6.776813669
Rn,86,105,191,1.2209302325581395,0,0.0,7.622616634
Rn,86,107,193,1.244186046511628,0,0.0,7.648744668
Rn,86,108,194,1.255813953488372,0,1.0,7.665595124
Rn,86,109,195,1.2674418604651163,0,0.0,7.670913149
Rn,86,110,196,1.2790697674418605,0,1.0,7.684517561
Rn,86,111,197,1.2906976744186047,0,0.0,7.689442066
Rn,86,112,198,1.302325581395349,0,1.0,7.70283553
Rn,86,113,199,1.313953488372093,0,0.0,7.707276789
Rn,86,114,200,1.3255813953488371,0,1.0,7.72034719
Rn,86,115,201,1.3372093023255813,0,0.0,7.724044652
Rn,86,116,202,1.3488372093023255,0,1.0,7.736107817
Rn,86,117,203,1.3604651162790697,0,0.0,7.738991665
Rn,86,118,204,1.372093023255814,0,1.0,7.749908108
Rn,86,119,205,1.3837209302325582,0,0.0,7.751748224
Rn,86,120,206,1.3953488372093024,0,1.0,7.761183932
Rn,86,121,207,1.4069767441860466,0,0.0,7.762806778
Rn,86,122,208,1.4186046511627908,0,1.0,7.771729769
Rn,86,123,209,1.430232558139535,0,0.0,7.772185062
Rn,86,124,210,1.441860465116279,0,1.0,7.779940462
Rn,86,125,211,1.4534883720930232,0,0.0,7.777775588
Rn,86,126,212,1.4651162790697674,1,1.0,7.785171538
Rn,86,127,213,1.4767441860465116,0,0.0,7.766498122
Rn,86,128,214,1.4883720930232558,0,1.0,7.757007757
Rn,86,129,215,1.5,0,0.0,7.739493377
Rn,86,130,216,1.5116279069767442,0,1.0,7.728383546
Rn,86,131,217,1.5232558139534884,0,0.0,7.712905945
Rn,86,132,218,1.5348837209302326,0,1.0,7.703775312
Rn,86,133,219,1.5465116279069768,0,0.0,7.687379447
Rn,86,134,220,1.558139534883721,0,1.0,7.677463077
Rn,86,135,221,1.569767441860465,0,0.0,7.66057671
Rn,86,136,222,1.5813953488372092,0,1.0,7.6502485
Rn,86,137,223,1.5930232558139534,0,0.0,7.633431233
Rn,86,138,224,1.6046511627906976,0,1.0,7.623213996
Rn,86,139,225,1.6162790697674418,0,0.0,7.606199516
Rn,86,140,226,1.627906976744186,0,1.0,7.59579708
Rn,86,141,227,1.6395348837209303,0,0.0,7.578275238
Rn,86,142,228,1.6511627906976745,0,1.0,7.567309316
Rn,86,143,229,1.6627906976744187,0,0.0,7.549401231
Rn,86,144,230,1.6744186046511629,0,1.0,7.53793413
Rn,86,145,231,1.686046511627907,0,0.0,7.51972629
Rn,86,146,232,1.697674418604651,0,1.0,7.507848336
Rn,86,147,233,1.7093023255813953,0,0.0,7.489043275
Rn,86,148,234,1.7209302325581395,0,1.0,7.476517902
Rn,86,149,235,1.7325581395348837,0,0.0,7.456737409
Rn,86,150,236,1.744186046511628,0,1.0,7.443221881
Rn,86,151,237,1.755813953488372,0,0.0,7.422460266
Rn,86,152,238,1.7674418604651163,0,1.0,7.407841748
Rn,86,153,239,1.7790697674418605,0,0.0,7.386736084
Rn,86,154,240,1.7906976744186047,0,1.0,7.371595921
Rn,86,155,241,1.802325581395349,0,0.0,7.350618817
Rn,86,156,242,1.813953488372093,0,1.0,7.33555036
Rn,86,157,243,1.8255813953488371,0,0.0,7.314469156
Rn,86,158,244,1.8372093023255813,0,1.0,7.299330164
Rn,86,159,245,1.8488372093023255,0,0.0,7.277965661
Rn,86,160,246,1.8604651162790697,0,1.0,7.262581016
Rn,86,161,247,1.872093023255814,0,0.0,7.240659449
Rn,86,162,248,1.8837209302325582,0,1.0,7.224688871
Rn,86,163,249,1.8953488372093024,0,0.0,7.202290225
Rn,86,164,250,1.9069767441860466,0,1.0,7.185770776
Rn,86,165,251,1.9186046511627908,0,0.0,7.163462641
Rn,86,166,252,1.930232558139535,0,1.0,7.147066151
Rn,86,167,253,1.941860465116279,0,0.0,7.12505496
Rn,86,168,254,1.9534883720930232,0,1.0,7.109041902
Rn,86,169,255,1.9651162790697674,0,0.0,7.087284588
Rn,86,170,256,1.9767441860465116,0,1.0,7.071491008
Rn,86,171,257,1.9883720930232558,0,0.0,7.049793926
Rn,86,172,258,2.0,0,1.0,7.033901973
Rn,86,173,259,2.011627906976744,0,0.0,7.012751595
Rn,86,174,260,2.0232558139534884,0,1.0,6.997342031
Rn,86,175,261,2.0348837209302326,0,0.0,6.976513946
Rn,86,176,262,2.046511627906977,0,1.0,6.961339893
Rn,86,177,263,2.058139534883721,0,0.0,6.940055924
Rn,86,178,264,2.0697674418604652,0,1.0,6.924118068
Rn,86,179,265,2.0813953488372094,0,0.0,6.902616868
Rn,86,180,266,2.0930232558139537,0,1.0,6.886099842
Rn,86,181,267,2.104651162790698,0,0.0,6.865105352
Rn,86,182,268,2.116279069767442,0,1.0,6.848837772
Rn,86,183,269,2.127906976744186,0,0.0,6.826325086
Rn,86,184,270,2.13953488372093,0,1.0,6.809823437
Fr,87,110,197,1.264367816091954,0,0.0,7.642681711
Fr,87,112,199,1.2873563218390804,0,0.0,7.663571462
Fr,87,113,200,1.2988505747126438,0,-1.0,7.669210865
Fr,87,114,201,1.3103448275862069,0,0.0,7.683193458
Fr,87,115,202,1.3218390804597702,0,-1.0,7.687934876
Fr,87,116,203,1.3333333333333333,0,0.0,7.700769596
Fr,87,117,204,1.3448275862068966,0,-1.0,7.704355172
Fr,87,118,205,1.3563218390804597,0,0.0,7.715681683
Fr,87,119,206,1.367816091954023,0,-1.0,7.718434714
Fr,87,120,207,1.3793103448275863,0,0.0,7.728534324
Fr,87,121,208,1.3908045977011494,0,-1.0,7.731179332
Fr,87,122,209,1.4022988505747127,0,0.0,7.740945
Fr,87,123,210,1.4137931034482758,0,-1.0,7.742251686
Fr,87,124,211,1.4252873563218391,0,0.0,7.750727417
Fr,87,125,212,1.4367816091954022,0,-1.0,7.749737618
Fr,87,126,213,1.4482758620689655,1,0.0,7.758205286
Fr,87,127,214,1.4597701149425288,0,-1.0,7.740770019
Fr,87,128,215,1.471264367816092,0,0.0,7.732481037
Fr,87,129,216,1.4827586206896552,0,-1.0,7.716985421
Fr,87,130,217,1.4942528735632183,0,0.0,7.70780347
Fr,87,131,218,1.5057471264367817,0,-1.0,7.694312491
Fr,87,132,219,1.5172413793103448,0,0.0,7.686996553
Fr,87,133,220,1.528735632183908,0,-1.0,7.6725448
Fr,87,134,221,1.5402298850574712,0,0.0,7.664391235
Fr,87,135,222,1.5517241379310345,0,-1.0,7.649497631
Fr,87,136,223,1.5632183908045978,0,0.0,7.640921713
Fr,87,137,224,1.5747126436781609,0,-1.0,7.625948241
Fr,87,138,225,1.5862068965517242,0,0.0,7.61731936
Fr,87,139,226,1.5977011494252873,0,-1.0,7.601865195
Fr,87,140,227,1.6091954022988506,0,0.0,7.592786339
Fr,87,141,228,1.6206896551724137,0,-1.0,7.576664496
Fr,87,142,229,1.632183908045977,0,0.0,7.56689148
Fr,87,143,230,1.6436781609195403,0,-1.0,7.550207409
Fr,87,144,231,1.6551724137931034,0,0.0,7.539802584
Fr,87,145,232,1.6666666666666667,0,-1.0,7.522560737
Fr,87,146,233,1.6781609195402298,0,0.0,7.511529768
Fr,87,147,234,1.6896551724137931,0,-1.0,7.493541218
Fr,87,148,235,1.7011494252873562,0,0.0,7.481746187
Fr,87,149,236,1.7126436781609196,0,-1.0,7.462702436
Fr,87,150,237,1.7241379310344827,0,0.0,7.449865886
Fr,87,151,238,1.735632183908046,0,-1.0,7.429817929
Fr,87,152,239,1.7471264367816093,0,0.0,7.415871987
Fr,87,153,240,1.7586206896551724,0,-1.0,7.395500783
Fr,87,154,241,1.7701149425287357,0,0.0,7.381061768
Fr,87,155,242,1.7816091954022988,0,-1.0,7.360840793
Fr,87,156,243,1.793103448275862,0,0.0,7.346495025
Fr,87,157,244,1.8045977011494252,0,-1.0,7.32622193
Fr,87,158,245,1.8160919540229885,0,0.0,7.311854955
Fr,87,159,246,1.8275862068965518,0,-1.0,7.291333073
Fr,87,160,247,1.839080459770115,0,0.0,7.276754024
Fr,87,161,248,1.8505747126436782,0,-1.0,7.255637081
Fr,87,162,249,1.8620689655172413,0,0.0,7.240433671
Fr,87,163,250,1.8735632183908046,0,-1.0,7.218727512
Fr,87,164,251,1.8850574712643677,0,0.0,7.202838283
Fr,87,165,252,1.896551724137931,0,-1.0,7.181139115
Fr,87,166,253,1.9080459770114941,0,0.0,7.165234423
Fr,87,167,254,1.9195402298850575,0,-1.0,7.143845906
Fr,87,168,255,1.9310344827586208,0,0.0,7.128299082
Fr,87,169,256,1.9425287356321839,0,-1.0,7.107241773
Fr,87,170,257,1.9540229885057472,0,0.0,7.091994054
Fr,87,171,258,1.9655172413793103,0,-1.0,7.070998349
Fr,87,172,259,1.9770114942528736,0,0.0,7.055672131
Fr,87,173,260,1.9885057471264367,0,-1.0,7.034752262
Fr,87,174,261,2.0,0,0.0,7.019360582
Fr,87,175,262,2.0114942528735633,0,-1.0,6.998860576
Fr,87,176,263,2.0229885057471266,0,0.0,6.983829403
Fr,87,177,264,2.0344827586206895,0,-1.0,6.963199106
Fr,87,178,265,2.045977011494253,0,0.0,6.947846887
Fr,87,179,266,2.057471264367816,0,-1.0,6.926921211
Fr,87,180,267,2.0689655172413794,0,0.0,6.910915105
Fr,87,181,268,2.0804597701149423,0,-1.0,6.890366709
Fr,87,182,269,2.0919540229885056,0,0.0,6.874471669
Fr,87,183,270,2.103448275862069,0,-1.0,6.852389074
Fr,87,184,271,2.1149425287356323,0,0.0,6.836240458
Ra,88,110,198,1.25,0,1.0,7.608089793
Ra,88,111,199,1.2613636363636365,0,0.0,7.615461131
Ra,88,112,200,1.2727272727272727,0,1.0,7.63098694
Ra,88,113,201,1.2840909090909092,0,0.0,7.637742711
Ra,88,114,202,1.2954545454545454,0,1.0,7.652559371
Ra,88,115,203,1.3068181818181819,0,0.0,7.658416877
Ra,88,116,204,1.3181818181818181,0,1.0,7.67209725
Ra,88,117,205,1.3295454545454546,0,0.0,7.676362176
Ra,88,118,206,1.3409090909090908,0,1.0,7.688079437
Ra,88,119,207,1.3522727272727273,0,0.0,7.691769517
Ra,88,120,208,1.3636363636363635,0,1.0,7.702559327
Ra,88,121,209,1.375,0,0.0,7.706251043
Ra,88,122,210,1.3863636363636365,0,1.0,7.71688541
Ra,88,123,211,1.3977272727272727,0,0.0,7.719173427
Ra,88,124,212,1.4090909090909092,0,1.0,7.728499434
Ra,88,125,213,1.4204545454545454,0,0.0,7.728620568
Ra,88,126,214,1.4318181818181819,1,1.0,7.738097393
Ra,88,127,215,1.4431818181818181,0,0.0,7.721839707
Ra,88,128,216,1.4545454545454546,0,1.0,7.714692444
Ra,88,129,217,1.4659090909090908,0,0.0,7.70075759
Ra,88,130,218,1.4772727272727273,0,1.0,7.693050537
Ra,88,131,219,1.4886363636363635,0,0.0,7.681275489
Ra,88,132,220,1.5,0,1.0,7.675507564
Ra,88,133,221,1.5113636363636365,0,0.0,7.662804946
Ra,88,134,222,1.5227272727272727,0,1.0,7.656222604
Ra,88,135,223,1.5340909090909092,0,0.0,7.643171314
Ra,88,136,224,1.5454545454545454,0,1.0,7.636200732
Ra,88,137,225,1.5568181818181819,0,0.0,7.623022258
Ra,88,138,226,1.5681818181818181,0,1.0,7.615935642
Ra,88,139,227,1.5795454545454546,0,0.0,7.602119269
Ra,88,140,228,1.5909090909090908,0,1.0,7.594442877
Ra,88,141,229,1.6022727272727273,0,0.0,7.57984648
Ra,88,142,230,1.6136363636363635,0,1.0,7.571392513
Ra,88,143,231,1.625,0,0.0,7.556012961
Ra,88,144,232,1.6363636363636365,0,1.0,7.546751621
Ra,88,145,233,1.6477272727272727,0,0.0,7.530501416
Ra,88,146,234,1.6590909090909092,0,1.0,7.520343889
Ra,88,147,235,1.6704545454545454,0,0.0,7.503172013
Ra,88,148,236,1.6818181818181819,0,1.0,7.492108208
Ra,88,149,237,1.6931818181818181,0,0.0,7.473797135
Ra,88,150,238,1.7045454545454546,0,1.0,7.461636021
Ra,88,151,239,1.7159090909090908,0,0.0,7.442295523
Ra,88,152,240,1.7272727272727273,0,1.0,7.429016354
Ra,88,153,241,1.7386363636363635,0,0.0,7.409367772
Ra,88,154,242,1.75,0,1.0,7.395618442
Ra,88,155,243,1.7613636363636365,0,0.0,7.376135317
Ra,88,156,244,1.7727272727272727,0,1.0,7.362494393
Ra,88,157,245,1.7840909090909092,0,0.0,7.342991127
Ra,88,158,246,1.7954545454545454,0,1.0,7.3293585
Ra,88,159,247,1.8068181818181819,0,0.0,7.30963504
Ra,88,160,248,1.8181818181818181,0,1.0,7.295818048
Ra,88,161,249,1.8295454545454546,0,0.0,7.275474133
Ra,88,162,250,1.8409090909090908,0,1.0,7.26100684
Ra,88,163,251,1.8522727272727273,0,0.0,7.239976657
Ra,88,164,252,1.8636363636363635,0,1.0,7.224701754
Ra,88,165,253,1.875,0,0.0,7.203558462
Ra,88,166,254,1.8863636363636365,0,1.0,7.188093811
Ra,88,167,255,1.8977272727272727,0,0.0,7.1672188
Ra,88,168,256,1.9090909090909092,0,1.0,7.152031117
Ra,88,169,257,1.9204545454545454,0,0.0,7.13157179
Ra,88,170,258,1.9318181818181819,0,1.0,7.116769903
Ra,88,171,259,1.9431818181818181,0,0.0,7.096383521
Ra,88,172,260,1.9545454545454546,0,1.0,7.081532742
Ra,88,173,261,1.9659090909090908,0,0.0,7.060871387
Ra,88,174,262,1.9772727272727273,0,1.0,7.045527004
Ra,88,175,263,1.9886363636363635,0,0.0,7.025286163
Ra,88,176,264,2.0,0,1.0,7.010330871
Ra,88,177,265,2.0113636363636362,0,0.0,6.990285072
Ra,88,178,266,2.022727272727273,0,1.0,6.975450338
Ra,88,179,267,2.034090909090909,0,0.0,6.955059831
Ra,88,180,268,2.0454545454545454,0,1.0,6.939525075
Ra,88,181,269,2.0568181818181817,0,0.0,6.919441636
Ra,88,182,270,2.0681818181818183,0,1.0,6.903938396
Ra,88,183,271,2.0795454545454546,0,0.0,6.882275793
Ra,88,184,272,2.090909090909091,0,1.0,6.866470746
Ac,89,112,201,1.2584269662921348,0,0.0,7.588415627
Ac,89,114,203,1.2808988764044944,0,0.0,7.612072118
Ac,89,116,205,1.303370786516854,0,0.0,7.633734024
Ac,89,118,207,1.3258426966292134,0,0.0,7.65151486
Ac,89,119,208,1.3370786516853932,0,-1.0,7.655652293
Ac,89,120,209,1.348314606741573,0,0.0,7.666768301
Ac,89,121,210,1.3595505617977528,0,-1.0,7.671408752
Ac,89,122,211,1.3707865168539326,0,0.0,7.682863284
Ac,89,123,212,1.3820224719101124,0,-1.0,7.686282524
Ac,89,124,213,1.3932584269662922,0,0.0,7.696611493
Ac,89,125,214,1.404494382022472,0,-1.0,7.697854047
Ac,89,126,215,1.4157303370786516,1,0.0,7.708339874
Ac,89,127,216,1.4269662921348314,0,-1.0,7.693343912
Ac,89,128,217,1.4382022471910112,0,0.0,7.68741576
Ac,89,129,218,1.449438202247191,0,-1.0,7.675014436
Ac,89,130,219,1.4606741573033708,0,0.0,7.668804228
Ac,89,131,220,1.4719101123595506,0,-1.0,7.658823232
Ac,89,132,221,1.4831460674157304,0,0.0,7.654764538
Ac,89,133,222,1.4943820224719102,0,-1.0,7.644178153
Ac,89,134,223,1.5056179775280898,0,0.0,7.639607561
Ac,89,135,224,1.5168539325842696,0,-1.0,7.628865549
Ac,89,136,225,1.5280898876404494,0,0.0,7.624095533
Ac,89,137,226,1.5393258426966292,0,-1.0,7.612643195
Ac,89,138,227,1.550561797752809,0,0.0,7.607172784
Ac,89,139,228,1.5617977528089888,0,-1.0,7.59473414
Ac,89,140,229,1.5730337078651686,0,0.0,7.588286358
Ac,89,141,230,1.5842696629213484,0,-1.0,7.574956365
Ac,89,142,231,1.595505617977528,0,0.0,7.567617372
Ac,89,143,232,1.6067415730337078,0,-1.0,7.553329931
Ac,89,144,233,1.6179775280898876,0,0.0,7.545042502
Ac,89,145,234,1.6292134831460674,0,-1.0,7.529714167
Ac,89,146,235,1.6404494382022472,0,0.0,7.5203766
Ac,89,147,236,1.651685393258427,0,-1.0,7.50401428
Ac,89,148,237,1.6629213483146068,0,0.0,7.49367508
Ac,89,149,238,1.6741573033707866,0,-1.0,7.476113412
Ac,89,150,239,1.6853932584269662,0,0.0,7.464639958
Ac,89,151,240,1.696629213483146,0,-1.0,7.446044058
Ac,89,152,241,1.7078651685393258,0,0.0,7.433451012
Ac,89,153,242,1.7191011235955056,0,-1.0,7.414563079
Ac,89,154,243,1.7303370786516854,0,0.0,7.401508029
Ac,89,155,244,1.7415730337078652,0,-1.0,7.382788426
Ac,89,156,245,1.752808988764045,0,0.0,7.369840796
Ac,89,157,246,1.7640449438202248,0,-1.0,7.351108402
Ac,89,158,247,1.7752808988764044,0,0.0,7.338173502
Ac,89,159,248,1.7865168539325842,0,-1.0,7.319199964
Ac,89,160,249,1.797752808988764,0,0.0,7.306063759
Ac,89,161,250,1.8089887640449438,0,-1.0,7.286380304
Ac,89,162,251,1.8202247191011236,0,0.0,7.272513693
Ac,89,163,252,1.8314606741573034,0,-1.0,7.251979155
Ac,89,164,253,1.8426966292134832,0,0.0,7.237114154
Ac,89,165,254,1.853932584269663,0,-1.0,7.216424161
Ac,89,166,255,1.8651685393258426,0,0.0,7.201281886
Ac,89,167,256,1.8764044943820224,0,-1.0,7.180943777
Ac,89,168,257,1.8876404494382022,0,0.0,7.166149895
Ac,89,169,258,1.898876404494382,0,-1.0,7.146416329
Ac,89,170,259,1.9101123595505618,0,0.0,7.132213181
Ac,89,171,260,1.9213483146067416,0,-1.0,7.112648488
Ac,89,172,261,1.9325842696629214,0,0.0,7.098526663
Ac,89,173,262,1.9438202247191012,0,-1.0,7.078574351
Ac,89,174,263,1.9550561797752808,0,0.0,7.063870179
Ac,89,175,264,1.9662921348314606,0,-1.0,7.043976201
Ac,89,176,265,1.9775280898876404,0,0.0,7.029198479
Ac,89,177,266,1.9887640449438202,0,-1.0,7.009827045
Ac,89,178,267,2.0,0,0.0,6.995504933
Ac,89,179,268,2.0112359550561796,0,-1.0,6.975759922
Ac,89,180,269,2.0224719101123596,0,0.0,6.960801714
Ac,89,181,270,2.033707865168539,0,-1.0,6.941435344
Ac,89,182,271,2.044943820224719,0,0.0,6.926546734
Ac,89,183,272,2.056179775280899,0,-1.0,6.905346574
Ac,89,184,273,2.067415730337079,0,0.0,6.889909088
Ac,89,196,285,2.202247191011236,0,0.0,6.584774533
Ac,89,198,287,2.2247191011235956,0,0.0,6.539966561
Ac,89,200,289,2.247191011235955,0,0.0,6.495342993
Th,90,113,203,1.2555555555555555,0,0.0,7.561773616
Th,90,114,204,1.2666666666666666,0,1.0,7.578359093
Th,90,115,205,1.2777777777777777,0,0.0,7.586516151
Th,90,116,206,1.288888888888889,0,1.0,7.602130544
Th,90,117,207,1.3,0,0.0,7.60835157
Th,90,118,208,1.3111111111111111,0,1.0,7.621759082
Th,90,119,209,1.3222222222222222,0,0.0,7.626467565
Th,90,120,210,1.3333333333333333,0,1.0,7.638033443
Th,90,121,211,1.3444444444444446,0,0.0,7.643671782
Th,90,122,212,1.3555555555555556,0,1.0,7.655996382
Th,90,123,213,1.3666666666666667,0,0.0,7.66067177
Th,90,124,214,1.3777777777777778,0,1.0,7.672128664
Th,90,125,215,1.3888888888888888,0,0.0,7.674435837
Th,90,126,216,1.4,1,1.0,7.685875426
Th,90,127,217,1.4111111111111112,0,0.0,7.672065848
Th,90,128,218,1.4222222222222223,0,1.0,7.667282555
Th,90,129,219,1.4333333333333333,0,0.0,7.655935909
Th,90,130,220,1.4444444444444444,0,1.0,7.650748377
Th,90,131,221,1.4555555555555555,0,0.0,7.642250398
Th,90,132,222,1.4666666666666666,0,1.0,7.639593464
Th,90,133,223,1.4777777777777779,0,0.0,7.630867529
Th,90,134,224,1.488888888888889,0,1.0,7.628056125
Th,90,135,225,1.5,0,0.0,7.619455631
Th,90,136,226,1.511111111111111,0,1.0,7.616720867
Th,90,137,227,1.5222222222222221,0,0.0,7.606922846
Th,90,138,228,1.5333333333333334,0,1.0,7.602998417
Th,90,139,229,1.5444444444444445,0,0.0,7.591958179
Th,90,140,230,1.5555555555555556,0,1.0,7.586760796
Th,90,141,231,1.5666666666666667,0,0.0,7.574778229
Th,90,142,232,1.5777777777777777,0,1.0,7.568635819
Th,90,143,233,1.5888888888888888,0,0.0,7.555523124
Th,90,144,234,1.6,0,1.0,7.548292543
Th,90,145,235,1.6111111111111112,0,0.0,7.5339182
Th,90,146,236,1.6222222222222222,0,1.0,7.525433301
Th,90,147,237,1.6333333333333333,0,0.0,7.509881219
Th,90,148,238,1.6444444444444444,0,1.0,7.500268017
Th,90,149,239,1.6555555555555554,0,0.0,7.483452121
Th,90,150,240,1.6666666666666667,0,1.0,7.472663246
Th,90,151,241,1.6777777777777778,0,0.0,7.454814747
Th,90,152,242,1.6888888888888889,0,1.0,7.442911087
Th,90,153,243,1.7,0,0.0,7.424790379
Th,90,154,244,1.711111111111111,0,1.0,7.412436664
Th,90,155,245,1.7222222222222223,0,0.0,7.394480653
Th,90,156,246,1.7333333333333334,0,1.0,7.382226955
Th,90,157,247,1.7444444444444445,0,0.0,7.364242895
Th,90,158,248,1.7555555555555555,0,1.0,7.35198396
Th,90,159,249,1.7666666666666666,0,0.0,7.333724076
Th,90,160,250,1.7777777777777777,0,1.0,7.321233232
Th,90,161,251,1.788888888888889,0,0.0,7.302167367
Th,90,162,252,1.8,0,1.0,7.288859381
Th,90,163,253,1.8111111111111111,0,0.0,7.268769605
Th,90,164,254,1.8222222222222222,0,1.0,7.254264709
Th,90,165,255,1.8333333333333333,0,0.0,7.233963412
Th,90,166,256,1.8444444444444446,0,1.0,7.219080445
Th,90,167,257,1.8555555555555556,0,0.0,7.199212782
Th,90,168,258,1.8666666666666667,0,1.0,7.184747872
Th,90,169,259,1.8777777777777778,0,0.0,7.165701243
Th,90,170,260,1.8888888888888888,0,1.0,7.152059281
Th,90,171,261,1.9,0,0.0,7.133298084
Th,90,172,262,1.9111111111111112,0,1.0,7.119887855
Th,90,173,263,1.9222222222222223,0,0.0,7.100628141
Th,90,174,264,1.9333333333333333,0,1.0,7.086548379
Th,90,175,265,1.9444444444444444,0,0.0,7.066984936
Th,90,176,266,1.9555555555555555,0,1.0,7.052369853
Th,90,177,267,1.9666666666666666,0,0.0,7.03356715
Th,90,178,268,1.9777777777777779,0,1.0,7.019654022
Th,90,179,269,1.988888888888889,0,0.0,7.000521335
Th,90,180,270,2.0,0,1.0,6.986107263
Th,90,181,271,2.011111111111111,0,0.0,6.967457557
Th,90,182,272,2.022222222222222,0,1.0,6.953183934
Th,90,183,273,2.033333333333333,0,0.0,6.932448916
Th,90,184,274,2.0444444444444443,0,1.0,6.917382347
Th,90,194,284,2.1555555555555554,0,1.0,6.663139099
Th,90,196,286,2.1777777777777776,0,1.0,6.618795353
Th,90,198,288,2.2,0,1.0,6.575687872
Th,90,200,290,2.2222222222222223,0,1.0,6.532552386
Th,90,202,292,2.2444444444444445,0,1.0,6.488945226
Pa,91,116,207,1.2747252747252746,0,0.0,7.560509715
Pa,91,118,209,1.2967032967032968,0,0.0,7.58205878
Pa,91,120,211,1.3186813186813187,0,0.0,7.599603161
Pa,91,122,213,1.3406593406593406,0,0.0,7.619134216
Pa,91,123,214,1.3516483516483517,0,-1.0,7.624874519
Pa,91,124,215,1.3626373626373627,0,0.0,7.637318679
Pa,91,125,216,1.3736263736263736,0,-1.0,7.640795625
Pa,91,126,217,1.3846153846153846,1,0.0,7.653332134
Pa,91,127,218,1.3956043956043955,0,-1.0,7.64080761
Pa,91,128,219,1.4065934065934067,0,0.0,7.637267032
Pa,91,129,220,1.4175824175824177,0,-1.0,7.627209973
Pa,91,130,221,1.4285714285714286,0,0.0,7.623299964
Pa,91,131,222,1.4395604395604396,0,-1.0,7.61657255
Pa,91,132,223,1.4505494505494505,0,0.0,7.615652749
Pa,91,133,224,1.4615384615384615,0,-1.0,7.608982589
Pa,91,134,225,1.4725274725274726,0,0.0,7.608248009
Pa,91,135,226,1.4835164835164836,0,-1.0,7.601476394
Pa,91,136,227,1.4945054945054945,0,0.0,7.600657396
Pa,91,137,228,1.5054945054945055,0,-1.0,7.592317526
Pa,91,138,229,1.5164835164835164,0,0.0,7.589900795
Pa,91,139,230,1.5274725274725274,0,-1.0,7.580188009
Pa,91,140,231,1.5384615384615385,0,0.0,7.576283221
Pa,91,141,232,1.5494505494505495,0,-1.0,7.565564129
Pa,91,142,233,1.5604395604395604,0,0.0,7.560631069
Pa,91,143,234,1.5714285714285714,0,-1.0,7.548631585
Pa,91,144,235,1.5824175824175823,0,0.0,7.542464813
Pa,91,145,236,1.5934065934065933,0,-1.0,7.529081631
Pa,91,146,237,1.6043956043956045,0,0.0,7.521525489
Pa,91,147,238,1.6153846153846154,0,-1.0,7.506912954
Pa,91,148,239,1.6263736263736264,0,0.0,7.498170665
Pa,91,149,240,1.6373626373626373,0,-1.0,7.482252046
Pa,91,150,241,1.6483516483516483,0,0.0,7.472304805
Pa,91,151,242,1.6593406593406594,0,-1.0,7.455263702
Pa,91,152,243,1.6703296703296704,0,0.0,7.444111704
Pa,91,153,244,1.6813186813186813,0,-1.0,7.426711873
Pa,91,154,245,1.6923076923076923,0,0.0,7.415007237
Pa,91,155,246,1.7032967032967032,0,-1.0,7.397728049
Pa,91,156,247,1.7142857142857142,0,0.0,7.386074267
Pa,91,157,248,1.7252747252747254,0,-1.0,7.36874729
Pa,91,158,249,1.7362637362637363,0,0.0,7.357070044
Pa,91,159,250,1.7472527472527473,0,-1.0,7.339456912
Pa,91,160,251,1.7582417582417582,0,0.0,7.327545235
Pa,91,161,252,1.7692307692307692,0,-1.0,7.309078036
Pa,91,162,253,1.7802197802197801,0,0.0,7.296323107
Pa,91,163,254,1.7912087912087913,0,-1.0,7.276738272
Pa,91,164,255,1.8021978021978022,0,0.0,7.26267849
Pa,91,165,256,1.8131868131868132,0,-1.0,7.24291891
Pa,91,166,257,1.8241758241758241,0,0.0,7.228478276
Pa,91,167,258,1.835164835164835,0,-1.0,7.20922543
Pa,91,168,259,1.8461538461538463,0,0.0,7.195264969
Pa,91,169,260,1.8571428571428572,0,-1.0,7.1768187
Pa,91,170,261,1.8681318681318682,0,0.0,7.16367392
Pa,91,171,262,1.879120879120879,0,-1.0,7.145515786
Pa,91,172,263,1.89010989010989,0,0.0,7.132630601
Pa,91,173,264,1.901098901098901,0,-1.0,7.113863985
Pa,91,174,265,1.9120879120879122,0,0.0,7.100228026
Pa,91,175,266,1.9230769230769231,0,-1.0,7.081335534
Pa,91,176,267,1.934065934065934,0,0.0,7.067448566
Pa,91,177,268,1.945054945054945,0,-1.0,7.049332
Pa,91,178,269,1.956043956043956,0,0.0,7.036154048
Pa,91,179,270,1.967032967032967,0,-1.0,7.017790011
Pa,91,180,271,1.978021978021978,0,0.0,7.004077232
Pa,91,181,272,1.989010989010989,0,-1.0,6.98587846
Pa,91,182,273,2.0,0,0.0,6.971974718
Pa,91,183,274,2.010989010989011,0,-1.0,6.951705785
Pa,91,184,275,2.021978021978022,0,0.0,6.93702616
Pa,91,186,277,2.043956043956044,0,0.0,6.886980675
Pa,91,194,285,2.131868131868132,0,0.0,6.688825449
Pa,91,196,287,2.1538461538461537,0,0.0,6.64660547
Pa,91,198,289,2.1758241758241756,0,0.0,6.605074381
Pa,91,200,291,2.197802197802198,0,0.0,6.563339058
Pa,91,202,293,2.21978021978022,0,0.0,6.52108243
Pa,91,204,295,2.241758241758242,0,0.0,6.477687092
U,92,117,209,1.2717391304347827,0,0.0,7.534100622
U,92,118,210,1.2826086956521738,0,1.0,7.549364748
U,92,119,211,1.2934782608695652,0,0.0,7.555577493
U,92,120,212,1.3043478260869565,0,1.0,7.56854375
U,92,121,213,1.315217391304348,0,0.0,7.575887347
U,92,122,214,1.326086956521739,0,1.0,7.589748678
U,92,123,215,1.3369565217391304,0,0.0,7.596644591
U,92,124,216,1.3478260869565217,0,1.0,7.610166597
U,92,125,217,1.358695652173913,0,0.0,7.614752442
U,92,126,218,1.3695652173913044,1,1.0,7.628326234
U,92,127,219,1.3804347826086956,0,0.0,7.61700563
U,92,128,220,1.391304347826087,0,1.0,7.614627755
U,92,129,221,1.4021739130434783,0,0.0,7.605434647
U,92,130,222,1.4130434782608696,0,1.0,7.602380468
U,92,131,223,1.423913043478261,0,0.0,7.597033578
U,92,132,224,1.434782608695652,0,1.0,7.597464656
U,92,133,225,1.4456521739130435,0,0.0,7.592552453
U,92,134,226,1.4565217391304348,0,1.0,7.593599323
U,92,135,227,1.4673913043478262,0,0.0,7.588568718
U,92,136,228,1.4782608695652173,0,1.0,7.589577627
U,92,137,229,1.4891304347826086,0,0.0,7.58266955
U,92,138,230,1.5,0,1.0,7.581733961
U,92,139,231,1.5108695652173914,0,0.0,7.573337732
U,92,140,232,1.5217391304347827,0,1.0,7.570715039
U,92,141,233,1.5326086956521738,0,0.0,7.561268142
U,92,142,234,1.5434782608695652,0,1.0,7.55755353
U,92,143,235,1.5543478260869565,0,0.0,7.546680919
U,92,144,236,1.565217391304348,0,1.0,7.541591898
U,92,145,237,1.576086956521739,0,0.0,7.529188722
U,92,146,238,1.5869565217391304,0,1.0,7.522550794
U,92,147,239,1.5978260869565217,0,0.0,7.508848536
U,92,148,240,1.608695652173913,0,1.0,7.500948704
U,92,149,241,1.6195652173913044,0,0.0,7.485913058
U,92,150,242,1.6304347826086956,0,1.0,7.476793727
U,92,151,243,1.641304347826087,0,0.0,7.460574831
U,92,152,244,1.6521739130434783,0,1.0,7.450189635
U,92,153,245,1.6630434782608696,0,0.0,7.433526857
U,92,154,246,1.673913043478261,0,1.0,7.422487923
U,92,155,247,1.684782608695652,0,0.0,7.405887506
U,92,156,248,1.6956521739130435,0,1.0,7.394836185
U,92,157,249,1.7065217391304348,0,0.0,7.378152892
U,92,158,250,1.7173913043478262,0,1.0,7.367044652
U,92,159,251,1.7282608695652173,0,0.0,7.350047653
U,92,160,252,1.7391304347826086,0,1.0,7.338685306
U,92,161,253,1.75,0,0.0,7.320776249
U,92,162,254,1.7608695652173914,0,1.0,7.30853452
U,92,163,255,1.7717391304347827,0,0.0,7.289392227
U,92,164,256,1.7826086956521738,0,1.0,7.275716113
U,92,165,257,1.7934782608695652,0,0.0,7.256426767
U,92,166,258,1.8043478260869565,0,1.0,7.242358302
U,92,167,259,1.815217391304348,0,0.0,7.223660568
U,92,168,260,1.826086956521739,0,1.0,7.210146165
U,92,169,261,1.8369565217391304,0,0.0,7.192280525
U,92,170,262,1.8478260869565217,0,1.0,7.179614134
U,92,171,263,1.858695652173913,0,0.0,7.162076479
U,92,172,264,1.8695652173913044,0,1.0,7.149734212
U,92,173,265,1.8804347826086956,0,0.0,7.131493532
U,92,174,266,1.891304347826087,0,1.0,7.118334335
U,92,175,267,1.9021739130434783,0,0.0,7.100132899
U,92,176,268,1.9130434782608696,0,1.0,7.086993578
U,92,177,269,1.923913043478261,0,0.0,7.069502301
U,92,178,270,1.934782608695652,0,1.0,7.056998756
U,92,179,271,1.9456521739130435,0,0.0,7.039444908
U,92,180,272,1.9565217391304348,0,1.0,7.026475151
U,92,181,273,1.9673913043478262,0,0.0,7.008697106
U,92,182,274,1.9782608695652173,0,1.0,6.995133861
U,92,183,275,1.9891304347826086,0,0.0,6.975325233
U,92,184,276,2.0,0,1.0,6.961027377
U,92,186,278,2.0217391304347827,0,1.0,6.912099676
U,92,194,286,2.108695652173913,0,1.0,6.718127829
U,92,195,287,2.119565217391304,0,0.0,6.695606721
U,92,196,288,2.130434782608696,0,1.0,6.677748611
U,92,197,289,2.141304347826087,0,0.0,6.655362716
U,92,198,290,2.152173913043478,0,1.0,6.6376436
U,92,199,291,2.1630434782608696,0,0.0,6.61513199
U,92,200,292,2.1739130434782608,0,1.0,6.597233438
U,92,202,294,2.1956521739130435,0,1.0,6.556286949
U,92,204,296,2.217391304347826,0,1.0,6.514135801
U,92,206,298,2.239130434782609,0,1.0,6.470600678
Np,93,122,215,1.3118279569892473,0,0.0,7.550342758
Np,93,124,217,1.3333333333333333,0,0.0,7.57267777
Np,93,126,219,1.3548387096774193,1,0.0,7.592982694
Np,93,127,220,1.3655913978494623,0,-1.0,7.582930041
Np,93,128,221,1.3763440860215055,0,0.0,7.581769606
Np,93,129,222,1.3870967741935485,0,-1.0,7.573904725
Np,93,130,223,1.3978494623655915,0,0.0,7.572163157
Np,93,131,224,1.4086021505376345,0,-1.0,7.568529777
Np,93,132,225,1.4193548387096775,0,0.0,7.570686564
Np,93,133,226,1.4301075268817205,0,-1.0,7.567348531
Np,93,134,227,1.4408602150537635,0,0.0,7.570059101
Np,93,135,228,1.4516129032258065,0,-1.0,7.566220706
Np,93,136,229,1.4623655913978495,0,0.0,7.568532472
Np,93,137,230,1.4731182795698925,0,-1.0,7.562852696
Np,93,138,231,1.4838709677419355,0,0.0,7.563211576
Np,93,139,232,1.4946236559139785,0,-1.0,7.556133582
Np,93,140,233,1.5053763440860215,0,0.0,7.554870815
Np,93,141,234,1.5161290322580645,0,-1.0,7.546723594
Np,93,142,235,1.5268817204301075,0,0.0,7.544336945
Np,93,143,236,1.5376344086021505,0,-1.0,7.534701479
Np,93,144,237,1.5483870967741935,0,0.0,7.530842857
Np,93,145,238,1.5591397849462365,0,-1.0,7.519660609
Np,93,146,239,1.5698924731182795,0,0.0,7.514198762
Np,93,147,240,1.5806451612903225,0,-1.0,7.501698196
Np,93,148,241,1.5913978494623655,0,0.0,7.494934137
Np,93,149,242,1.6021505376344085,0,-1.0,7.481029405
Np,93,150,243,1.6129032258064515,0,0.0,7.472978321
Np,93,151,244,1.6236559139784945,0,-1.0,7.457688295
Np,93,152,245,1.6344086021505377,0,0.0,7.4481806
Np,93,153,246,1.6451612903225807,0,-1.0,7.432267967
Np,93,154,247,1.6559139784946237,0,0.0,7.421921498
Np,93,155,248,1.6666666666666667,0,-1.0,7.406001504
Np,93,156,249,1.6774193548387097,0,0.0,7.395568402
Np,93,157,250,1.6881720430107527,0,-1.0,7.379515616
Np,93,158,251,1.6989247311827957,0,0.0,7.36898298
Np,93,159,252,1.7096774193548387,0,-1.0,7.352594393
Np,93,160,253,1.7204301075268817,0,0.0,7.341794636
Np,93,161,254,1.7311827956989247,0,-1.0,7.324466669
Np,93,162,255,1.7419354838709677,0,0.0,7.312779886
Np,93,163,256,1.7526881720430108,0,-1.0,7.294164027
Np,93,164,257,1.7634408602150538,0,0.0,7.28097916
Np,93,165,258,1.7741935483870968,0,-1.0,7.262265589
Np,93,166,259,1.7849462365591398,0,0.0,7.248700104
Np,93,167,260,1.7956989247311828,0,-1.0,7.230608546
Np,93,168,261,1.8064516129032258,0,0.0,7.217610736
Np,93,169,262,1.8172043010752688,0,-1.0,7.200234908
Np,93,170,263,1.8279569892473118,0,0.0,7.187963027
Np,93,171,264,1.8387096774193548,0,-1.0,7.170923265
Np,93,172,265,1.8494623655913978,0,0.0,7.15900183
Np,93,173,266,1.8602150537634408,0,-1.0,7.141206383
Np,93,174,267,1.8709677419354838,0,0.0,7.128458067
Np,93,175,268,1.881720430107527,0,-1.0,7.111233746
Np,93,176,269,1.89247311827957,0,0.0,7.099021766
Np,93,177,270,1.903225806451613,0,-1.0,7.081890489
Np,93,178,271,1.913978494623656,0,0.0,7.069689889
Np,93,179,272,1.924731182795699,0,-1.0,7.05227611
Np,93,180,273,1.935483870967742,0,0.0,7.039417612
Np,93,181,274,1.946236559139785,0,-1.0,7.022162438
Np,93,182,275,1.956989247311828,0,0.0,7.009098989
Np,93,183,276,1.967741935483871,0,-1.0,6.989850547
Np,93,184,277,1.978494623655914,0,0.0,6.97607178
Np,93,186,279,2.0,0,0.0,6.928389061
Np,93,192,285,2.064516129032258,0,0.0,6.782788744
Np,93,193,286,2.075268817204301,0,-1.0,6.759458126
Np,93,194,287,2.086021505376344,0,0.0,6.740827195
Np,93,195,288,2.096774193548387,0,-1.0,6.719091656
Np,93,196,289,2.10752688172043,0,0.0,6.702043623
Np,93,197,290,2.118279569892473,0,-1.0,6.680312531
Np,93,198,291,2.129032258064516,0,0.0,6.663293553
Np,93,199,292,2.139784946236559,0,-1.0,6.641426421
Np,93,200,293,2.150537634408602,0,0.0,6.624209123
Np,93,201,294,2.161290322580645,0,-1.0,6.602078204
Np,93,202,295,2.172043010752688,0,0.0,6.58456421
Np,93,204,297,2.193548387096774,0,0.0,6.543747118
Np,93,206,299,2.21505376344086,0,0.0,6.501543023
Pu,94,123,217,1.3085106382978724,0,0.0,7.527584253
Pu,94,124,218,1.3191489361702127,0,1.0,7.542978619
Pu,94,125,219,1.3297872340425532,0,0.0,7.549731416
Pu,94,126,220,1.3404255319148937,1,1.0,7.565287164
Pu,94,127,221,1.351063829787234,0,0.0,7.556416557
Pu,94,128,222,1.3617021276595744,0,1.0,7.556388883
Pu,94,129,223,1.372340425531915,0,0.0,7.54949883
Pu,94,130,224,1.3829787234042554,0,1.0,7.548719759
Pu,94,131,225,1.3936170212765957,0,0.0,7.546363587
Pu,94,132,226,1.4042553191489362,0,1.0,7.549813544
Pu,94,133,227,1.4148936170212767,0,0.0,7.547725833
Pu,94,134,228,1.425531914893617,0,1.0,7.551778298
Pu,94,135,229,1.4361702127659575,0,0.0,7.549002568
Pu,94,136,230,1.446808510638298,0,1.0,7.5524878
Pu,94,137,231,1.4574468085106382,0,0.0,7.547970502
Pu,94,138,232,1.4680851063829787,0,1.0,7.549558017
Pu,94,139,233,1.4787234042553192,0,0.0,7.543746927
Pu,94,140,234,1.4893617021276595,0,1.0,7.543792829
Pu,94,141,235,1.5,0,0.0,7.536913068
Pu,94,142,236,1.5106382978723405,0,1.0,7.535822208
Pu,94,143,237,1.5212765957446808,0,0.0,7.527409932
Pu,94,144,238,1.5319148936170213,0,1.0,7.524767916
Pu,94,145,239,1.5425531914893618,0,0.0,7.514801289
Pu,94,146,240,1.553191489361702,0,1.0,7.510510629
Pu,94,147,241,1.5638297872340425,0,0.0,7.499213299
Pu,94,148,242,1.574468085106383,0,1.0,7.493587087
Pu,94,149,243,1.5851063829787233,0,0.0,7.480828955
Pu,94,150,244,1.5957446808510638,0,1.0,7.473862189
Pu,94,151,245,1.6063829787234043,0,0.0,7.459523004
Pu,94,152,246,1.6170212765957446,0,1.0,7.450915024
Pu,94,153,247,1.627659574468085,0,0.0,7.43575817
Pu,94,154,248,1.6382978723404256,0,1.0,7.426110222
Pu,94,155,249,1.648936170212766,0,0.0,7.410858209
Pu,94,156,250,1.6595744680851063,0,1.0,7.401031476
Pu,94,157,251,1.6702127659574468,0,0.0,7.385591972
Pu,94,158,252,1.6808510638297873,0,1.0,7.37561829
Pu,94,159,253,1.6914893617021276,0,0.0,7.359828277
Pu,94,160,254,1.702127659574468,0,1.0,7.349581717
Pu,94,161,255,1.7127659574468086,0,0.0,7.33283078
Pu,94,162,256,1.7234042553191489,0,1.0,7.321695121
Pu,94,163,257,1.7340425531914894,0,0.0,7.303587393
Pu,94,164,258,1.7446808510638299,0,1.0,7.290875884
Pu,94,165,259,1.7553191489361701,0,0.0,7.272705432
Pu,94,166,260,1.7659574468085106,0,1.0,7.259611073
Pu,94,167,261,1.7765957446808511,0,0.0,7.242091536
Pu,94,168,262,1.7872340425531914,0,1.0,7.229577111
Pu,94,169,263,1.797872340425532,0,0.0,7.212664559
Pu,94,170,264,1.8085106382978724,0,1.0,7.200761568
Pu,94,171,265,1.8191489361702127,0,0.0,7.184208174
Pu,94,172,266,1.8297872340425532,0,1.0,7.172696699
Pu,94,173,267,1.8404255319148937,0,0.0,7.155357536
Pu,94,174,268,1.851063829787234,0,1.0,7.143031313
Pu,94,175,269,1.8617021276595744,0,0.0,7.126781257
Pu,94,176,270,1.872340425531915,0,1.0,7.115494163
Pu,94,177,271,1.8829787234042554,0,0.0,7.0987359
Pu,94,178,272,1.8936170212765957,0,1.0,7.086851588
Pu,94,179,273,1.9042553191489362,0,0.0,7.069636165
Pu,94,180,274,1.9148936170212767,0,1.0,7.056946993
Pu,94,181,275,1.925531914893617,0,0.0,7.040177596
Pu,94,182,276,1.9361702127659575,0,1.0,7.027577283
Pu,94,183,277,1.946808510638298,0,0.0,7.008859621
Pu,94,184,278,1.9574468085106382,0,1.0,6.995571036
Pu,94,186,280,1.9787234042553192,0,1.0,6.949088768
Pu,94,188,282,2.0,0,1.0,6.900378532
Pu,94,190,284,2.021276595744681,0,1.0,6.852169754
Pu,94,192,286,2.0425531914893615,0,1.0,6.807796175
Pu,94,193,287,2.0531914893617023,0,0.0,6.785183007
Pu,94,194,288,2.0638297872340425,0,1.0,6.767244281
Pu,94,195,289,2.074468085106383,0,0.0,6.746180363
Pu,94,196,290,2.0851063829787235,0,1.0,6.729829072
Pu,94,197,291,2.095744680851064,0,0.0,6.708694887
Pu,94,198,292,2.106382978723404,0,1.0,6.69231825
Pu,94,199,293,2.117021276595745,0,0.0,6.67105544
Pu,94,200,294,2.127659574468085,0,1.0,6.654479255
Pu,94,201,295,2.1382978723404253,0,0.0,6.632956373
Pu,94,202,296,2.148936170212766,0,1.0,6.616070767
Pu,94,203,297,2.1595744680851063,0,0.0,6.594006155
Pu,94,204,298,2.1702127659574466,0,1.0,6.576534265
Pu,94,206,300,2.1914893617021276,0,1.0,6.535628433
Pu,94,208,302,2.2127659574468086,0,1.0,6.493356275
Am,95,126,221,1.3263157894736841,1,0.0,7.527225339
Am,95,128,223,1.3473684210526315,0,0.0,7.520740789
Am,95,130,225,1.368421052631579,0,0.0,7.516012276
Am,95,131,226,1.3789473684210527,0,-1.0,7.515168341
Am,95,132,227,1.3894736842105264,0,0.0,7.520157947
Am,95,133,228,1.4,0,-1.0,7.519376136
Am,95,134,229,1.4105263157894736,0,0.0,7.524822122
Am,95,135,230,1.4210526315789473,0,-1.0,7.523226774
Am,95,136,231,1.431578947368421,0,0.0,7.527964316
Am,95,137,232,1.4421052631578948,0,-1.0,7.524741017
Am,95,138,233,1.4526315789473685,0,0.0,7.52767573
Am,95,139,234,1.4631578947368422,0,-1.0,7.523199821
Am,95,140,235,1.4736842105263157,0,0.0,7.524648311
Am,95,141,236,1.4842105263157894,0,-1.0,7.519029475
Am,95,142,237,1.4947368421052631,0,0.0,7.519257658
Am,95,143,238,1.5052631578947369,0,-1.0,7.512039601
Am,95,144,239,1.5157894736842106,0,0.0,7.510606565
Am,95,145,240,1.5263157894736843,0,-1.0,7.501812525
Am,95,146,241,1.5368421052631578,0,0.0,7.498668079
Am,95,147,242,1.5473684210526315,0,-1.0,7.488527095
Am,95,148,243,1.5578947368421052,0,0.0,7.484004584
Am,95,149,244,1.568421052631579,0,-1.0,7.472376176
Am,95,150,245,1.5789473684210527,0,0.0,7.466476849
Am,95,151,246,1.5894736842105264,0,-1.0,7.453158703
Am,95,152,247,1.6,0,0.0,7.445519688
Am,95,153,248,1.6105263157894736,0,-1.0,7.431238613
Am,95,154,249,1.6210526315789473,0,0.0,7.422416249
Am,95,155,250,1.631578947368421,0,-1.0,7.407938368
Am,95,156,251,1.6421052631578947,0,0.0,7.398832622
Am,95,157,252,1.6526315789473685,0,-1.0,7.384077294
Am,95,158,253,1.6631578947368422,0,0.0,7.374737953
Am,95,159,254,1.6736842105263159,0,-1.0,7.359560157
Am,95,160,255,1.6842105263157894,0,0.0,7.349886357
Am,95,161,256,1.694736842105263,0,-1.0,7.333711988
Am,95,162,257,1.7052631578947368,0,0.0,7.323147685
Am,95,163,258,1.7157894736842105,0,-1.0,7.305545988
Am,95,164,259,1.7263157894736842,0,0.0,7.293337884
Am,95,165,260,1.736842105263158,0,-1.0,7.275693412
Am,95,166,261,1.7473684210526317,0,0.0,7.263087207
Am,95,167,262,1.7578947368421052,0,-1.0,7.246087477
Am,95,168,263,1.768421052631579,0,0.0,7.234043137
Am,95,169,264,1.7789473684210526,0,-1.0,7.217575591
Am,95,170,265,1.7894736842105263,0,0.0,7.206065362
Am,95,171,266,1.8,0,-1.0,7.190215511
Am,95,172,267,1.8105263157894738,0,0.0,7.179455674
Am,95,173,268,1.8210526315789475,0,-1.0,7.162844407
Am,95,174,269,1.831578947368421,0,0.0,7.151299584
Am,95,175,270,1.8421052631578947,0,-1.0,7.135414219
Am,95,176,271,1.8526315789473684,0,0.0,7.124434956
Am,95,177,272,1.8631578947368421,0,-1.0,7.10801314
Am,95,178,273,1.8736842105263158,0,0.0,7.096434179
Am,95,179,274,1.8842105263157896,0,-1.0,7.079444036
Am,95,180,275,1.894736842105263,0,0.0,7.066991069
Am,95,181,276,1.9052631578947368,0,-1.0,7.050417895
Am,95,182,277,1.9157894736842105,0,0.0,7.038000751
Am,95,183,278,1.9263157894736842,0,-1.0,7.01988705
Am,95,184,279,1.936842105263158,0,0.0,7.007154147
Am,95,186,281,1.9578947368421054,0,0.0,6.961876801
Am,95,188,283,1.9789473684210526,0,0.0,6.914387484
Am,95,190,285,2.0,0,0.0,6.86835193
Am,95,191,286,2.0105263157894737,0,-1.0,6.844723147
Am,95,192,287,2.0210526315789474,0,0.0,6.826018118
Am,95,193,288,2.031578947368421,0,-1.0,6.804138833
Am,95,194,289,2.042105263157895,0,0.0,6.786915516
Am,95,195,290,2.0526315789473686,0,-1.0,6.766365066
Am,95,196,291,2.0631578947368423,0,0.0,6.750543564
Am,95,197,292,2.0736842105263156,0,-1.0,6.729945288
Am,95,198,293,2.0842105263157893,0,0.0,6.714126956
Am,95,199,294,2.094736842105263,0,-1.0,6.693448469
Am,95,200,295,2.1052631578947367,0,0.0,6.677478231
Am,95,201,296,2.1157894736842104,0,-1.0,6.656564855
Am,95,202,297,2.126315789473684,0,0.0,6.64029834
Am,95,203,298,2.136842105263158,0,-1.0,6.618894903
Am,95,204,299,2.1473684210526316,0,0.0,6.602081017
Am,95,206,301,2.168421052631579,0,0.0,6.562530688
Am,95,208,303,2.1894736842105265,0,0.0,6.521525092
Am,95,210,305,2.210526315789474,0,0.0,6.479438495
Cm,96,127,223,1.3229166666666667,0,0.0,7.490380951
Cm,96,128,224,1.3333333333333333,0,1.0,7.492614732
Cm,96,129,225,1.34375,0,0.0,7.488396133
Cm,96,130,226,1.3541666666666667,0,1.0,7.490225058
Cm,96,131,227,1.3645833333333333,0,0.0,7.490430934
Cm,96,132,228,1.375,0,1.0,7.496501579
Cm,96,133,229,1.3854166666666667,0,0.0,7.49668176
Cm,96,134,230,1.3958333333333333,0,1.0,7.50317957
Cm,96,135,231,1.40625,0,0.0,7.502571407
Cm,96,136,232,1.4166666666666667,0,1.0,7.508369103
Cm,96,137,233,1.4270833333333333,0,0.0,7.506317318
Cm,96,138,234,1.4375,0,1.0,7.510477338
Cm,96,139,235,1.4479166666666667,0,0.0,7.507253417
Cm,96,140,236,1.4583333333333333,0,1.0,7.510021441
Cm,96,141,237,1.46875,0,0.0,7.505616835
Cm,96,142,238,1.4791666666666667,0,1.0,7.507117273
Cm,96,143,239,1.4895833333333333,0,0.0,7.501079025
Cm,96,144,240,1.5,0,1.0,7.500840558
Cm,96,145,241,1.5104166666666667,0,0.0,7.49323532
Cm,96,146,242,1.5208333333333333,0,1.0,7.491253388
Cm,96,147,243,1.53125,0,0.0,7.482302119
Cm,96,148,244,1.5416666666666667,0,1.0,7.478916836
Cm,96,149,245,1.5520833333333333,0,0.0,7.468451518
Cm,96,150,246,1.5625,0,1.0,7.463653236
Cm,96,151,247,1.5729166666666667,0,0.0,7.45137449
Cm,96,152,248,1.5833333333333333,0,1.0,7.444723077
Cm,96,153,249,1.59375,0,0.0,7.431319305
Cm,96,154,250,1.6041666666666667,0,1.0,7.423324432
Cm,96,155,251,1.6145833333333333,0,0.0,7.409614406
Cm,96,156,252,1.625,0,1.0,7.401223837
Cm,96,157,253,1.6354166666666667,0,0.0,7.387149059
Cm,96,158,254,1.6458333333333333,0,1.0,7.378440862
Cm,96,159,255,1.65625,0,0.0,7.36388898
Cm,96,160,256,1.6666666666666667,0,1.0,7.354801852
Cm,96,161,257,1.6770833333333333,0,0.0,7.339223101
Cm,96,162,258,1.6875,0,1.0,7.329249089
Cm,96,163,259,1.6979166666666667,0,0.0,7.312164448
Cm,96,164,260,1.7083333333333333,0,1.0,7.300470715
Cm,96,165,261,1.71875,0,0.0,7.283340073
Cm,96,166,262,1.7291666666666667,0,1.0,7.271210252
Cm,96,167,263,1.7395833333333333,0,0.0,7.254709627
Cm,96,168,264,1.75,0,1.0,7.243115201
Cm,96,169,265,1.7604166666666667,0,0.0,7.227077683
Cm,96,170,266,1.7708333333333333,0,1.0,7.215945748
Cm,96,171,267,1.78125,0,0.0,7.200795955
Cm,96,172,268,1.7916666666666667,0,1.0,7.190783929
Cm,96,173,269,1.8020833333333333,0,0.0,7.174895454
Cm,96,174,270,1.8125,0,1.0,7.164126574
Cm,96,175,271,1.8229166666666667,0,0.0,7.148587779
Cm,96,176,272,1.8333333333333333,0,1.0,7.137898776
Cm,96,177,273,1.84375,0,0.0,7.12180378
Cm,96,178,274,1.8541666666666667,0,1.0,7.110520847
Cm,96,179,275,1.8645833333333333,0,0.0,7.093767513
Cm,96,180,276,1.875,0,1.0,7.081562116
Cm,96,181,277,1.8854166666666667,0,0.0,7.065188108
Cm,96,182,278,1.8958333333333333,0,1.0,7.052957151
Cm,96,183,279,1.90625,0,0.0,7.035408548
Cm,96,184,280,1.9166666666666667,0,1.0,7.023193086
Cm,96,185,281,1.9270833333333333,0,0.0,6.998260142
Cm,96,186,282,1.9375,0,1.0,6.979070035
Cm,96,188,284,1.9583333333333333,0,1.0,6.932747201
Cm,96,190,286,1.9791666666666667,0,1.0,6.888744458
Cm,96,191,287,1.9895833333333333,0,0.0,6.866156714
Cm,96,192,288,2.0,0,1.0,6.848265868
Cm,96,193,289,2.0104166666666665,0,0.0,6.826985716
Cm,96,194,290,2.0208333333333335,0,1.0,6.810344117
Cm,96,195,291,2.03125,0,0.0,6.790185478
Cm,96,196,292,2.0416666666666665,0,1.0,6.774772836
Cm,96,197,293,2.0520833333333335,0,0.0,6.754646618
Cm,96,198,294,2.0625,0,1.0,6.739323024
Cm,96,199,295,2.0729166666666665,0,0.0,6.719183298
Cm,96,200,296,2.0833333333333335,0,1.0,6.703773598
Cm,96,201,297,2.09375,0,0.0,6.683436909
Cm,96,202,298,2.1041666666666665,0,1.0,6.667756822
Cm,96,203,299,2.1145833333333335,0,0.0,6.64698997
Cm,96,204,300,2.125,0,1.0,6.630809683
Cm,96,205,301,2.1354166666666665,0,0.0,6.609434468
Cm,96,206,302,2.1458333333333335,0,1.0,6.592584699
Cm,96,208,304,2.1666666666666665,0,1.0,6.552826674
Cm,96,210,306,2.1875,0,1.0,6.511840676
Cm,96,212,308,2.2083333333333335,0,1.0,6.470559945
Cm,96,214,310,2.2291666666666665,0,1.0,6.4295157
Bk,97,128,225,1.3195876288659794,0,0.0,7.45443304
Bk,97,130,227,1.3402061855670102,0,0.0,7.455145084
Bk,97,132,229,1.3608247422680413,0,0.0,7.464021459
Bk,97,133,230,1.3711340206185567,0,-1.0,7.465375048
Bk,97,134,231,1.3814432989690721,0,0.0,7.473064351
Bk,97,135,232,1.3917525773195876,0,-1.0,7.473570909
Bk,97,136,233,1.402061855670103,0,0.0,7.480528966
Bk,97,137,234,1.4123711340206186,0,-1.0,7.479671692
Bk,97,138,235,1.422680412371134,0,0.0,7.485074085
Bk,97,139,236,1.4329896907216495,0,-1.0,7.483095818
Bk,97,140,237,1.443298969072165,0,0.0,7.487174882
Bk,97,141,238,1.4536082474226804,0,-1.0,7.483968479
Bk,97,142,239,1.4639175257731958,0,0.0,7.48672451
Bk,97,143,240,1.4742268041237114,0,-1.0,7.481849246
Bk,97,144,241,1.4845360824742269,0,0.0,7.482798357
Bk,97,145,242,1.4948453608247423,0,-1.0,7.476351083
Bk,97,146,243,1.5051546391752577,0,0.0,7.475520889
Bk,97,147,244,1.5154639175257731,0,-1.0,7.467711377
Bk,97,148,245,1.5257731958762886,0,0.0,7.465436547
Bk,97,149,246,1.5360824742268042,0,-1.0,7.456113829
Bk,97,150,247,1.5463917525773196,0,0.0,7.452407652
Bk,97,151,248,1.556701030927835,0,-1.0,7.441228
Bk,97,152,249,1.5670103092783505,0,0.0,7.435621197
Bk,97,153,250,1.577319587628866,0,-1.0,7.423202284
Bk,97,154,251,1.5876288659793814,0,0.0,7.416132454
Bk,97,155,252,1.597938144329897,0,-1.0,7.403288302
Bk,97,156,253,1.6082474226804124,0,0.0,7.395700996
Bk,97,157,254,1.6185567010309279,0,-1.0,7.382382728
Bk,97,158,255,1.6288659793814433,0,0.0,7.374374675
Bk,97,159,256,1.6391752577319587,0,-1.0,7.360534844
Bk,97,160,257,1.6494845360824741,0,0.0,7.352110918
Bk,97,161,258,1.6597938144329898,0,-1.0,7.337236492
Bk,97,162,259,1.6701030927835052,0,0.0,7.327952548
Bk,97,163,260,1.6804123711340206,0,-1.0,7.311417954
Bk,97,164,261,1.690721649484536,0,0.0,7.300277383
Bk,97,165,262,1.7010309278350515,0,-1.0,7.28363574
Bk,97,166,263,1.711340206185567,0,0.0,7.271982373
Bk,97,167,264,1.7216494845360826,0,-1.0,7.255924117
Bk,97,168,265,1.731958762886598,0,0.0,7.24474934
Bk,97,169,266,1.7422680412371134,0,-1.0,7.229195361
Bk,97,170,267,1.7525773195876289,0,0.0,7.218687255
Bk,97,171,268,1.7628865979381443,0,-1.0,7.204239549
Bk,97,172,269,1.7731958762886597,0,0.0,7.19507948
Bk,97,173,270,1.7835051546391754,0,-1.0,7.179644478
Bk,97,174,271,1.7938144329896908,0,0.0,7.169294871
Bk,97,175,272,1.8041237113402062,0,-1.0,7.154181221
Bk,97,176,273,1.8144329896907216,0,0.0,7.143858172
Bk,97,177,274,1.824742268041237,0,-1.0,7.128156854
Bk,97,178,275,1.8350515463917525,0,0.0,7.117257524
Bk,97,179,276,1.8453608247422681,0,-1.0,7.100740696
Bk,97,180,277,1.8556701030927836,0,0.0,7.08877643
Bk,97,181,278,1.865979381443299,0,-1.0,7.072642619
Bk,97,182,279,1.8762886597938144,0,0.0,7.0606191
Bk,97,183,280,1.8865979381443299,0,-1.0,7.043669825
Bk,97,184,281,1.8969072164948453,0,0.0,7.032004121
Bk,97,185,282,1.907216494845361,0,-1.0,7.007708383
Bk,97,186,283,1.9175257731958764,0,0.0,6.98911836
Bk,97,188,285,1.9381443298969072,0,0.0,6.943985646
Bk,97,189,286,1.9484536082474226,0,-1.0,6.92070328
Bk,97,190,287,1.958762886597938,0,0.0,6.902290122
Bk,97,191,288,1.9690721649484537,0,-1.0,6.880686757
Bk,97,192,289,1.9793814432989691,0,0.0,6.863716391
Bk,97,193,290,1.9896907216494846,0,-1.0,6.843123162
Bk,97,194,291,2.0,0,0.0,6.827157296
Bk,97,195,292,2.0103092783505154,0,-1.0,6.807454281
Bk,97,196,293,2.020618556701031,0,0.0,6.792500891
Bk,97,197,294,2.0309278350515463,0,-1.0,6.772936361
Bk,97,198,295,2.0412371134020617,0,0.0,6.758182719
Bk,97,199,296,2.051546391752577,0,-1.0,6.738591432
Bk,97,200,297,2.0618556701030926,0,0.0,6.723735589
Bk,97,201,298,2.0721649484536084,0,-1.0,6.703931674
Bk,97,202,299,2.082474226804124,0,0.0,6.688772829
Bk,97,203,300,2.0927835051546393,0,-1.0,6.66857636
Bk,97,204,301,2.1030927835051547,0,0.0,6.652947638
Bk,97,205,302,2.11340206185567,0,-1.0,6.632184735
Bk,97,206,303,2.1237113402061856,0,0.0,6.615936512
Bk,97,207,304,2.134020618556701,0,-1.0,6.594457204
Bk,97,208,305,2.1443298969072164,0,0.0,6.577410662
Bk,97,210,307,2.1649484536082473,0,0.0,6.537589433
Bk,97,212,309,2.185567010309278,0,0.0,6.497406806
Bk,97,214,311,2.2061855670103094,0,0.0,6.457445428
Bk,97,216,313,2.2268041237113403,0,0.0,6.416940898
Cf,98,129,227,1.316326530612245,0,0.0,7.422431934
Cf,98,130,228,1.3265306122448979,0,1.0,7.427035684
Cf,98,131,229,1.336734693877551,0,0.0,7.42940017
Cf,98,132,230,1.346938775510204,0,1.0,7.437589265
Cf,98,133,231,1.3571428571428572,0,0.0,7.43977668
Cf,98,134,232,1.3673469387755102,0,1.0,7.448320655
Cf,98,135,233,1.3775510204081634,0,0.0,7.449813064
Cf,98,136,234,1.3877551020408163,0,1.0,7.457803316
Cf,98,137,235,1.3979591836734695,0,0.0,7.458056838
Cf,98,138,236,1.4081632653061225,0,1.0,7.464618195
Cf,98,139,237,1.4183673469387754,0,0.0,7.463812316
Cf,98,140,238,1.4285714285714286,0,1.0,7.469129223
Cf,98,141,239,1.4387755102040816,0,0.0,7.467059732
Cf,98,142,240,1.4489795918367347,0,1.0,7.471010117
Cf,98,143,241,1.4591836734693877,0,0.0,7.467252295
Cf,98,144,242,1.469387755102041,0,1.0,7.469343628
Cf,98,145,243,1.4795918367346939,0,0.0,7.464023243
Cf,98,146,244,1.489795918367347,0,1.0,7.46431402
Cf,98,147,245,1.5,0,0.0,7.457632935
Cf,98,148,246,1.510204081632653,0,1.0,7.456455593
Cf,98,149,247,1.5204081632653061,0,0.0,7.448271891
Cf,98,150,248,1.530612244897959,0,1.0,7.445654673
Cf,98,151,249,1.5408163265306123,0,0.0,7.435575365
Cf,98,152,250,1.5510204081632653,0,1.0,7.431014856
Cf,98,153,251,1.5612244897959184,0,0.0,7.419583542
Cf,98,154,252,1.5714285714285714,0,1.0,7.413441948
Cf,98,155,253,1.5816326530612246,0,0.0,7.401464482
Cf,98,156,254,1.5918367346938775,0,1.0,7.39468174
Cf,98,157,255,1.6020408163265305,0,0.0,7.382125322
Cf,98,158,256,1.6122448979591837,0,1.0,7.374823152
Cf,98,159,257,1.6224489795918366,0,0.0,7.361708121
Cf,98,160,258,1.6326530612244898,0,1.0,7.353960426
Cf,98,161,259,1.6428571428571428,0,0.0,7.339814506
Cf,98,162,260,1.653061224489796,0,1.0,7.331244738
Cf,98,163,261,1.663265306122449,0,0.0,7.315283808
Cf,98,164,262,1.6734693877551021,0,1.0,7.304719813
Cf,98,165,263,1.683673469387755,0,0.0,7.288568578
Cf,98,166,264,1.6938775510204083,0,1.0,7.277393155
Cf,98,167,265,1.7040816326530612,0,0.0,7.261768389
Cf,98,168,266,1.7142857142857142,0,1.0,7.251004609
Cf,98,169,267,1.7244897959183674,0,0.0,7.235932891
Cf,98,170,268,1.7346938775510203,0,1.0,7.226046287
Cf,98,171,269,1.7448979591836735,0,0.0,7.212291721
Cf,98,172,270,1.7551020408163265,0,1.0,7.203973615
Cf,98,173,271,1.7653061224489797,0,0.0,7.188982601
Cf,98,174,272,1.7755102040816326,0,1.0,7.179043103
Cf,98,175,273,1.7857142857142858,0,0.0,7.164353249
Cf,98,176,274,1.7959183673469388,0,1.0,7.154395259
Cf,98,177,275,1.8061224489795917,0,0.0,7.139096629
Cf,98,178,276,1.816326530612245,0,1.0,7.128589931
Cf,98,179,277,1.8265306122448979,0,0.0,7.112354444
Cf,98,180,278,1.836734693877551,0,1.0,7.100675788
Cf,98,181,279,1.846938775510204,0,0.0,7.0848359
Cf,98,182,280,1.8571428571428572,0,1.0,7.0730734
Cf,98,183,281,1.8673469387755102,0,0.0,7.056679801
Cf,98,184,282,1.8775510204081634,0,1.0,7.045520872
Cf,98,185,283,1.8877551020408163,0,0.0,7.021819654
Cf,98,186,284,1.8979591836734695,0,1.0,7.003787588
Cf,98,187,285,1.9081632653061225,0,0.0,6.979335067
Cf,98,188,286,1.9183673469387754,0,1.0,6.959779822
Cf,98,189,287,1.9285714285714286,0,0.0,6.93751124
Cf,98,190,288,1.9387755102040816,0,1.0,6.920053753
Cf,98,191,289,1.9489795918367347,0,0.0,6.899339055
Cf,98,192,290,1.9591836734693877,0,1.0,6.883194566
Cf,98,193,291,1.969387755102041,0,0.0,6.863157237
Cf,98,194,292,1.9795918367346939,0,1.0,6.847737045
Cf,98,195,293,1.989795918367347,0,0.0,6.828333611
Cf,98,196,294,2.0,0,1.0,6.813684476
Cf,98,197,295,2.010204081632653,0,0.0,6.794600902
Cf,98,198,296,2.020408163265306,0,1.0,6.780336973
Cf,98,199,297,2.0306122448979593,0,0.0,6.761249077
Cf,98,200,298,2.0408163265306123,0,1.0,6.746902309
Cf,98,201,299,2.0510204081632653,0,0.0,6.727603033
Cf,98,202,300,2.061224489795918,0,1.0,6.712937553
Cf,98,203,301,2.0714285714285716,0,0.0,6.693289279
Cf,98,204,302,2.0816326530612246,0,1.0,6.678190209
Cf,98,205,303,2.0918367346938775,0,0.0,6.658020396
Cf,98,206,304,2.1020408163265305,0,1.0,6.642354697
Cf,98,207,305,2.1122448979591835,0,0.0,6.621470567
Cf,98,208,306,2.122448979591837,0,1.0,6.605021333
Cf,98,209,307,2.13265306122449,0,0.0,6.583552629
Cf,98,210,308,2.142857142857143,0,1.0,6.566333942
Cf,98,212,310,2.163265306122449,0,1.0,6.527226161
Cf,98,214,312,2.183673469387755,0,1.0,6.488332385
Cf,98,216,314,2.204081632653061,0,1.0,6.448888975
Cf,98,218,316,2.2244897959183674,0,1.0,6.408225222
Es,99,130,229,1.3131313131313131,0,0.0,7.39066431
Es,99,132,231,1.3333333333333333,0,0.0,7.403409242
Es,99,134,233,1.3535353535353536,0,0.0,7.415002464
Es,99,136,235,1.3737373737373737,0,0.0,7.426318145
Es,99,137,236,1.3838383838383839,0,-1.0,7.427583305
Es,99,138,237,1.393939393939394,0,0.0,7.43520843
Es,99,139,238,1.404040404040404,0,-1.0,7.435480181
Es,99,140,239,1.4141414141414141,0,0.0,7.44193205
Es,99,141,240,1.4242424242424243,0,-1.0,7.440955946
Es,99,142,241,1.4343434343434343,0,0.0,7.446040888
Es,99,143,242,1.4444444444444444,0,-1.0,7.443423438
Es,99,144,243,1.4545454545454546,0,0.0,7.446681033
Es,99,145,244,1.4646464646464648,0,-1.0,7.44255632
Es,99,146,245,1.4747474747474747,0,0.0,7.444056563
Es,99,147,246,1.4848484848484849,0,-1.0,7.438591878
Es,99,148,247,1.494949494949495,0,0.0,7.438621866
Es,99,149,248,1.505050505050505,0,-1.0,7.431673363
Es,99,150,249,1.5151515151515151,0,0.0,7.430265671
Es,99,151,250,1.5252525252525253,0,-1.0,7.421366016
Es,99,152,251,1.5353535353535352,0,0.0,7.417953622
Es,99,153,252,1.5454545454545454,0,-1.0,7.407583063
Es,99,154,253,1.5555555555555556,0,0.0,7.402454186
Es,99,155,254,1.5656565656565657,0,-1.0,7.391424598
Es,99,156,255,1.5757575757575757,0,0.0,7.385521698
Es,99,157,256,1.5858585858585859,0,-1.0,7.373849043
Es,99,158,257,1.595959595959596,0,0.0,7.36735244
Es,99,159,258,1.606060606060606,0,-1.0,7.355147186
Es,99,160,259,1.6161616161616161,0,0.0,7.348233069
Es,99,161,260,1.6262626262626263,0,-1.0,7.334956819
Es,99,162,261,1.6363636363636365,0,0.0,7.327225939
Es,99,163,262,1.6464646464646464,0,-1.0,7.311883462
Es,99,164,263,1.6565656565656566,0,0.0,7.301945532
Es,99,165,264,1.6666666666666667,0,-1.0,7.286262966
Es,99,166,265,1.6767676767676767,0,0.0,7.275557151
Es,99,167,266,1.6868686868686869,0,-1.0,7.260368274
Es,99,168,267,1.696969696969697,0,0.0,7.250030187
Es,99,169,268,1.707070707070707,0,-1.0,7.235431989
Es,99,170,269,1.7171717171717171,0,0.0,7.225988041
Es,99,171,270,1.7272727272727273,0,-1.0,7.212862578
Es,99,172,271,1.7373737373737375,0,0.0,7.205149886
Es,99,173,272,1.7474747474747474,0,-1.0,7.190641335
Es,99,174,273,1.7575757575757576,0,0.0,7.181164502
Es,99,175,274,1.7676767676767677,0,-1.0,7.166959982
Es,99,176,275,1.7777777777777777,0,0.0,7.157446825
Es,99,177,276,1.7878787878787878,0,-1.0,7.142618163
Es,99,178,277,1.797979797979798,0,0.0,7.132583368
Es,99,179,278,1.8080808080808082,0,-1.0,7.116638748
Es,99,180,279,1.8181818181818181,0,0.0,7.105256634
Es,99,181,280,1.8282828282828283,0,-1.0,7.089684389
Es,99,182,281,1.8383838383838385,0,0.0,7.07815231
Es,99,183,282,1.8484848484848484,0,-1.0,7.062326677
Es,99,184,283,1.8585858585858586,0,0.0,7.051684862
Es,99,185,284,1.8686868686868687,0,-1.0,7.028630479
Es,99,186,285,1.878787878787879,0,0.0,7.011208828
Es,99,187,286,1.8888888888888888,0,-1.0,6.987366329
Es,99,188,287,1.898989898989899,0,0.0,6.968411153
Es,99,189,288,1.9090909090909092,0,-1.0,6.947241931
Es,99,190,289,1.9191919191919191,0,0.0,6.930858654
Es,99,191,290,1.9292929292929293,0,-1.0,6.911006738
Es,99,192,291,1.9393939393939394,0,0.0,6.895708021
Es,99,193,292,1.9494949494949494,0,-1.0,6.876388712
Es,99,194,293,1.9595959595959596,0,0.0,6.861693648
Es,99,195,294,1.9696969696969697,0,-1.0,6.842866017
Es,99,196,295,1.97979797979798,0,0.0,6.828880271
Es,99,197,296,1.9898989898989898,0,-1.0,6.810242916
Es,99,198,297,2.0,0,0.0,6.796520508
Es,99,199,298,2.01010101010101,0,-1.0,6.777879144
Es,99,200,299,2.0202020202020203,0,0.0,6.763988565
Es,99,201,300,2.0303030303030303,0,-1.0,6.745156597
Es,99,202,301,2.04040404040404,0,0.0,6.730945645
Es,99,203,302,2.0505050505050506,0,-1.0,6.711818275
Es,99,204,303,2.0606060606060606,0,0.0,6.697221099
Es,99,205,304,2.0707070707070705,0,-1.0,6.677638349
Es,99,206,305,2.080808080808081,0,0.0,6.662543843
Es,99,207,306,2.090909090909091,0,-1.0,6.642287242
Es,99,208,307,2.101010101010101,0,0.0,6.626465544
Es,99,209,308,2.111111111111111,0,-1.0,6.605591425
Es,99,210,309,2.121212121212121,0,0.0,6.588980379
Es,99,211,310,2.1313131313131315,0,-1.0,6.567944668
Es,99,212,311,2.1414141414141414,0,0.0,6.550971585
Es,99,213,312,2.1515151515151514,0,-1.0,6.530042641
Es,99,214,313,2.1616161616161618,0,0.0,6.51312945
Es,99,216,315,2.1818181818181817,0,0.0,6.474809717
Es,99,218,317,2.202020202020202,0,0.0,6.435394779
Fm,100,131,231,1.31,0,0.0,7.364105216
Fm,100,133,233,1.33,0,0.0,7.378588888
Fm,100,134,234,1.34,0,1.0,7.387078184
Fm,100,135,235,1.35,0,0.0,7.391792353
Fm,100,136,236,1.36,0,1.0,7.400028826
Fm,100,137,237,1.37,0,0.0,7.403774675
Fm,100,138,238,1.38,0,1.0,7.410833008
Fm,100,139,239,1.39,0,0.0,7.413667494
Fm,100,140,240,1.4,0,1.0,7.419633013
Fm,100,141,241,1.41,0,0.0,7.42124529
Fm,100,142,242,1.42,0,1.0,7.42581938
Fm,100,143,243,1.43,0,0.0,7.425816918
Fm,100,144,244,1.44,0,1.0,7.428622697
Fm,100,145,245,1.45,0,0.0,7.427114449
Fm,100,146,246,1.46,0,1.0,7.428275691
Fm,100,147,247,1.47,0,0.0,7.425435543
Fm,100,148,248,1.48,0,1.0,7.425169621
Fm,100,149,249,1.49,0,0.0,7.420916365
Fm,100,150,250,1.5,0,1.0,7.419204004
Fm,100,151,251,1.51,0,0.0,7.412921753
Fm,100,152,252,1.52,0,1.0,7.409195163
Fm,100,153,253,1.53,0,0.0,7.401180289
Fm,100,154,254,1.54,0,1.0,7.395769075
Fm,100,155,255,1.55,0,0.0,7.386865933
Fm,100,156,256,1.56,0,1.0,7.380658633
Fm,100,157,257,1.57,0,0.0,7.370996883
Fm,100,158,258,1.58,0,1.0,7.364191589
Fm,100,159,259,1.59,0,0.0,7.353988062
Fm,100,160,260,1.6,0,1.0,7.346871562
Fm,100,161,261,1.61,0,0.0,7.335599318
Fm,100,162,262,1.62,0,1.0,7.327654748
Fm,100,163,263,1.63,0,0.0,7.313895376
Fm,100,164,264,1.64,0,1.0,7.303663409
Fm,100,165,265,1.65,0,0.0,7.289112777
Fm,100,166,266,1.66,0,1.0,7.278223767
Fm,100,167,267,1.67,0,0.0,7.264012386
Fm,100,168,268,1.68,0,1.0,7.253575146
Fm,100,169,269,1.69,0,0.0,7.240222082
Fm,100,170,270,1.7,0,1.0,7.230579696
Fm,100,171,271,1.71,0,0.0,7.218972782
Fm,100,172,272,1.72,0,1.0,7.210948316
Fm,100,173,273,1.73,0,0.0,7.197591004
Fm,100,174,274,1.74,0,1.0,7.187884358
Fm,100,175,275,1.75,0,0.0,7.174637556
Fm,100,176,276,1.76,0,1.0,7.165184678
Fm,100,177,277,1.77,0,0.0,7.151268011
Fm,100,178,278,1.78,0,1.0,7.141348101
Fm,100,179,279,1.79,0,0.0,7.125916487
Fm,100,180,280,1.8,0,1.0,7.114759807
Fm,100,181,281,1.81,0,0.0,7.099268544
Fm,100,182,282,1.82,0,1.0,7.088381174
Fm,100,183,283,1.83,0,0.0,7.073276689
Fm,100,184,284,1.84,0,1.0,7.062887106
Fm,100,185,285,1.85,0,0.0,7.040883681
Fm,100,186,286,1.86,0,1.0,7.023554147
Fm,100,187,287,1.87,0,0.0,7.000424533
Fm,100,188,288,1.88,0,1.0,6.981907306
Fm,100,189,289,1.89,0,0.0,6.96181319
Fm,100,190,290,1.9,0,1.0,6.94584919
Fm,100,191,291,1.91,0,0.0,6.927278533
Fm,100,192,292,1.92,0,1.0,6.912194058
Fm,100,193,293,1.93,0,0.0,6.894216696
Fm,100,194,294,1.94,0,1.0,6.879383595
Fm,100,195,295,1.95,0,0.0,6.861906308
Fm,100,196,296,1.96,0,1.0,6.847322081
Fm,100,197,297,1.97,0,0.0,6.830350354
Fm,100,198,298,1.98,0,1.0,6.816035557
Fm,100,199,299,1.99,0,0.0,6.798918943
Fm,100,200,300,2.0,0,1.0,6.784333957
Fm,100,201,301,2.01,0,0.0,6.767001834
Fm,100,202,302,2.02,0,1.0,6.752165901
Fm,100,203,303,2.03,0,0.0,6.734569611
Fm,100,204,304,2.04,0,1.0,6.719409566
Fm,100,205,305,2.05,0,0.0,6.701429384
Fm,100,206,306,2.06,0,1.0,6.685813631
Fm,100,207,307,2.07,0,0.0,6.667212192
Fm,100,208,308,2.08,0,1.0,6.65090262
Fm,100,209,309,2.09,0,0.0,6.63161455
Fm,100,210,310,2.1,0,1.0,6.61455801
Fm,100,211,311,2.11,0,0.0,6.594990084
Fm,100,212,312,2.12,0,1.0,6.577607468
Fm,100,213,313,2.13,0,0.0,6.55811822
Fm,100,214,314,2.14,0,1.0,6.540780857
Fm,100,215,315,2.15,0,0.0,6.521103486
Fm,100,216,316,2.16,0,1.0,6.503572335
Fm,100,217,317,2.17,0,0.0,6.483407577
Fm,100,218,318,2.18,0,1.0,6.465420673
Fm,100,220,320,2.2,0,1.0,6.426047484
Md,101,134,235,1.3267326732673268,0,0.0,7.353069987
Md,101,136,237,1.3465346534653466,0,0.0,7.366343409
Md,101,138,239,1.3663366336633664,0,0.0,7.378603661
Md,101,140,241,1.386138613861386,0,0.0,7.389697577
Md,101,141,242,1.396039603960396,0,-1.0,7.392404632
Md,101,142,243,1.4059405940594059,0,0.0,7.398106189
Md,101,143,244,1.4158415841584158,0,-1.0,7.399220426
Md,101,144,245,1.4257425742574257,0,0.0,7.403184045
Md,101,145,246,1.4356435643564356,0,-1.0,7.402828016
Md,101,146,247,1.4455445544554455,0,0.0,7.405176741
Md,101,147,248,1.4554455445544554,0,-1.0,7.403543855
Md,101,148,249,1.4653465346534653,0,0.0,7.404503012
Md,101,149,250,1.4752475247524752,0,-1.0,7.401484292
Md,101,150,251,1.4851485148514851,0,0.0,7.400997363
Md,101,151,252,1.495049504950495,0,-1.0,7.395898647
Md,101,152,253,1.504950495049505,0,0.0,7.393317822
Md,101,153,254,1.5148514851485149,0,-1.0,7.386359571
Md,101,154,255,1.5247524752475248,0,0.0,7.381941427
Md,101,155,256,1.5346534653465347,0,-1.0,7.37402643
Md,101,156,257,1.5445544554455446,0,0.0,7.368719218
Md,101,157,258,1.5544554455445545,0,-1.0,7.360067837
Md,101,158,259,1.5643564356435644,0,0.0,7.354156811
Md,101,159,260,1.5742574257425743,0,-1.0,7.345046842
Md,101,160,261,1.5841584158415842,0,0.0,7.338874805
Md,101,161,262,1.5940594059405941,0,-1.0,7.328567779
Md,101,162,263,1.603960396039604,0,0.0,7.321410734
Md,101,163,264,1.613861386138614,0,-1.0,7.308377242
Md,101,164,265,1.6237623762376239,0,0.0,7.298679272
Md,101,165,266,1.6336633663366336,0,-1.0,7.284679955
Md,101,166,267,1.6435643564356435,0,0.0,7.2741667
Md,101,167,268,1.6534653465346534,0,-1.0,7.2605045
Md,101,168,269,1.6633663366336633,0,0.0,7.250477554
Md,101,169,270,1.6732673267326732,0,-1.0,7.23743257
Md,101,170,271,1.683168316831683,0,0.0,7.228094118
Md,101,171,272,1.693069306930693,0,-1.0,7.217076037
Md,101,172,273,1.702970297029703,0,0.0,7.209676081
Md,101,173,274,1.7128712871287128,0,-1.0,7.196968901
Md,101,174,275,1.7227722772277227,0,0.0,7.187887411
Md,101,175,276,1.7326732673267327,0,-1.0,7.175235453
Md,101,176,277,1.7425742574257426,0,0.0,7.166366838
Md,101,177,278,1.7524752475247525,0,-1.0,7.153057004
Md,101,178,279,1.7623762376237624,0,0.0,7.143740043
Md,101,179,280,1.7722772277227723,0,-1.0,7.128855543
Md,101,180,281,1.7821782178217822,0,0.0,7.118246181
Md,101,181,282,1.7920792079207921,0,-1.0,7.103127635
Md,101,182,283,1.801980198019802,0,0.0,7.092635208
Md,101,183,284,1.811881188118812,0,-1.0,7.077839335
Md,101,184,285,1.8217821782178218,0,0.0,7.067801404
Md,101,185,286,1.8316831683168318,0,-1.0,7.046265678
Md,101,186,287,1.8415841584158417,0,0.0,7.029447634
Md,101,187,288,1.8514851485148516,0,-1.0,7.006651288
Md,101,188,289,1.8613861386138615,0,0.0,6.988515014
Md,101,189,290,1.8712871287128714,0,-1.0,6.969358552
Md,101,190,291,1.881188118811881,0,0.0,6.954357838
Md,101,191,292,1.891089108910891,0,-1.0,6.93638662
Md,101,192,293,1.900990099009901,0,0.0,6.921897601
Md,101,193,294,1.9108910891089108,0,-1.0,6.904541378
Md,101,194,295,1.9207920792079207,0,0.0,6.890300797
Md,101,195,296,1.9306930693069306,0,-1.0,6.874234574
Md,101,196,297,1.9405940594059405,0,0.0,6.860922293
Md,101,197,298,1.9504950495049505,0,-1.0,6.844005795
Md,101,198,299,1.9603960396039604,0,0.0,6.829560963
Md,101,199,300,1.9702970297029703,0,-1.0,6.812709517
Md,101,200,301,1.9801980198019802,0,0.0,6.798258977
Md,101,201,302,1.99009900990099,0,-1.0,6.781412911
Md,101,202,303,2.0,0,0.0,6.766994307
Md,101,203,304,2.00990099009901,0,-1.0,6.749975704
Md,101,204,305,2.01980198019802,0,0.0,6.735376098
Md,101,205,306,2.0297029702970297,0,-1.0,6.718032516
Md,101,206,307,2.0396039603960396,0,0.0,6.703042879
Md,101,207,308,2.0495049504950495,0,-1.0,6.685115948
Md,101,208,309,2.0594059405940595,0,0.0,6.669466515
Md,101,209,310,2.0693069306930694,0,-1.0,6.650853781
Md,101,210,311,2.0792079207920793,0,0.0,6.634447048
Md,101,211,312,2.089108910891089,0,-1.0,6.615500776
Md,101,212,313,2.099009900990099,0,0.0,6.598697914
Md,101,213,314,2.108910891089109,0,-1.0,6.579794646
Md,101,214,315,2.118811881188119,0,0.0,6.562984114
Md,101,215,316,2.128712871287129,0,-1.0,6.543932127
Md,101,216,317,2.1386138613861387,0,0.0,6.526947909
Md,101,217,318,2.1485148514851486,0,-1.0,6.507495311
Md,101,218,319,2.1584158415841586,0,0.0,6.490120132
Md,101,219,320,2.1683168316831685,0,-1.0,6.469982672
Md,101,220,321,2.1782178217821784,0,0.0,6.451962645
Md,101,222,323,2.198019801980198,0,0.0,6.41217131
No,102,134,236,1.3137254901960784,0,1.0,7.324896458
No,102,135,237,1.3235294117647058,0,0.0,7.33017016
No,102,136,238,1.3333333333333333,0,1.0,7.33843166
No,102,137,239,1.3431372549019607,0,0.0,7.343620435
No,102,138,240,1.3529411764705883,0,1.0,7.351869113
No,102,139,241,1.3627450980392157,0,0.0,7.356784465
No,102,140,242,1.3725490196078431,0,1.0,7.364841355
No,102,141,243,1.3823529411764706,0,0.0,7.368435263
No,102,142,244,1.392156862745098,0,1.0,7.375057807
No,102,143,245,1.4019607843137254,0,0.0,7.377100902
No,102,144,246,1.411764705882353,0,1.0,7.382035711
No,102,145,247,1.4215686274509804,0,0.0,7.382689296
No,102,146,248,1.4313725490196079,0,1.0,7.38608377
No,102,147,249,1.4411764705882353,0,0.0,7.385550888
No,102,148,250,1.4509803921568627,0,1.0,7.387628588
No,102,149,251,1.4607843137254901,0,0.0,7.385768805
No,102,150,252,1.4705882352941178,0,1.0,7.386432381
No,102,151,253,1.4803921568627452,0,0.0,7.382455237
No,102,152,254,1.4901960784313726,0,1.0,7.380959
No,102,153,255,1.5,0,0.0,7.375065388
No,102,154,256,1.5098039215686274,0,1.0,7.371648781
No,102,155,257,1.5196078431372548,0,0.0,7.364763327
No,102,156,258,1.5294117647058822,0,1.0,7.360397973
No,102,157,259,1.5392156862745099,0,0.0,7.352753027
No,102,158,260,1.5490196078431373,0,1.0,7.347733262
No,102,159,261,1.5588235294117647,0,0.0,7.339650552
No,102,160,262,1.5686274509803921,0,1.0,7.334358321
No,102,161,263,1.5784313725490196,0,0.0,7.325067487
No,102,162,264,1.588235294117647,0,1.0,7.31874989
No,102,163,265,1.5980392156862746,0,0.0,7.306444687
No,102,164,266,1.607843137254902,0,1.0,7.297284549
No,102,165,267,1.6176470588235294,0,0.0,7.28393376
No,102,166,268,1.6274509803921569,0,1.0,7.273894049
No,102,167,269,1.6372549019607843,0,0.0,7.260777747
No,102,168,270,1.6470588235294117,0,1.0,7.251158856
No,102,169,271,1.6568627450980393,0,0.0,7.238388745
No,102,170,272,1.6666666666666667,0,1.0,7.229321301
No,102,171,273,1.6764705882352942,0,0.0,7.218761055
No,102,172,274,1.6862745098039216,0,1.0,7.21185531
No,102,173,275,1.696078431372549,0,0.0,7.199571116
No,102,174,276,1.7058823529411764,0,1.0,7.190889464
No,102,175,277,1.7156862745098038,0,0.0,7.178718859
No,102,176,278,1.7254901960784315,0,1.0,7.170321899
No,102,177,279,1.7352941176470589,0,0.0,7.157525294
No,102,178,280,1.7450980392156863,0,1.0,7.148718375
No,102,179,281,1.7549019607843137,0,0.0,7.134127843
No,102,180,282,1.7647058823529411,0,1.0,7.123814454
No,102,181,283,1.7745098039215685,0,0.0,7.109036113
No,102,182,284,1.7843137254901962,0,1.0,7.09890619
No,102,183,285,1.7941176470588236,0,0.0,7.084762919
No,102,184,286,1.803921568627451,0,1.0,7.075417934
No,102,185,287,1.8137254901960784,0,0.0,7.054570056
No,102,186,288,1.8235294117647058,0,1.0,7.038481823
No,102,187,289,1.8333333333333333,0,0.0,7.016480277
No,102,188,290,1.8431372549019607,0,1.0,6.999182979
No,102,189,291,1.8529411764705883,0,0.0,6.980565072
No,102,190,292,1.8627450980392157,0,1.0,6.966131099
No,102,191,293,1.8725490196078431,0,0.0,6.948847044
No,102,192,294,1.8823529411764706,0,1.0,6.935040633
No,102,193,295,1.892156862745098,0,0.0,6.918406203
No,102,194,296,1.9019607843137254,0,1.0,6.904858304
No,102,195,297,1.911764705882353,0,0.0,6.890314286
No,102,196,298,1.9215686274509804,0,1.0,6.878385272
No,102,197,299,1.9313725490196079,0,0.0,6.861545227
No,102,198,300,1.9411764705882353,0,1.0,6.846992673
No,102,199,301,1.9509803921568627,0,0.0,6.830339302
No,102,200,302,1.9607843137254901,0,1.0,6.815957434
No,102,201,303,1.9705882352941178,0,0.0,6.799461512
No,102,202,304,1.9803921568627452,0,1.0,6.785325678
No,102,203,305,1.9901960784313726,0,0.0,6.768784915
No,102,204,306,2.0,0,1.0,6.754646673
No,102,205,307,2.0098039215686274,0,0.0,6.737858391
No,102,206,308,2.019607843137255,0,1.0,6.723414162
No,102,207,309,2.0294117647058822,0,0.0,6.706098531
No,102,208,310,2.0392156862745097,0,1.0,6.691046523
No,102,209,311,2.049019607843137,0,0.0,6.673043042
No,102,210,312,2.0588235294117645,0,1.0,6.657220622
No,102,211,313,2.0686274509803924,0,0.0,6.638862319
No,102,212,314,2.0784313725490198,0,1.0,6.62260601
No,102,213,315,2.088235294117647,0,0.0,6.604260143
No,102,214,316,2.0980392156862746,0,1.0,6.587948418
No,102,215,317,2.107843137254902,0,0.0,6.569483631
No,102,216,318,2.1176470588235294,0,1.0,6.553008903
No,102,217,319,2.127450980392157,0,0.0,6.534226103
No,102,218,320,2.1372549019607843,0,1.0,6.517421188
No,102,219,321,2.1470588235294117,0,0.0,6.49792266
No,102,220,322,2.156862745098039,0,1.0,6.480420795
No,102,222,324,2.176470588235294,0,1.0,6.44148659
Lr,103,138,241,1.3398058252427185,0,0.0,7.317436141
Lr,103,140,243,1.3592233009708738,0,0.0,7.332453391
Lr,103,142,245,1.3786407766990292,0,0.0,7.344714041
Lr,103,143,246,1.3883495145631068,0,-1.0,7.347786134
Lr,103,144,247,1.3980582524271845,0,0.0,7.35375898
Lr,103,145,248,1.4077669902912622,0,-1.0,7.355484032
Lr,103,146,249,1.4174757281553398,0,0.0,7.359963394
Lr,103,147,250,1.4271844660194175,0,-1.0,7.360601912
Lr,103,148,251,1.4368932038834952,0,0.0,7.363848809
Lr,103,149,252,1.4466019417475728,0,-1.0,7.363214095
Lr,103,150,253,1.4563106796116505,0,0.0,7.365074344
Lr,103,151,254,1.4660194174757282,0,-1.0,7.36226637
Lr,103,152,255,1.4757281553398058,0,0.0,7.361886122
Lr,103,153,256,1.4854368932038835,0,-1.0,7.357048734
Lr,103,154,257,1.4951456310679612,0,0.0,7.35461049
Lr,103,155,258,1.5048543689320388,0,-1.0,7.348759539
Lr,103,156,259,1.5145631067961165,0,0.0,7.345323707
Lr,103,157,260,1.5242718446601942,0,-1.0,7.338781746
Lr,103,158,261,1.5339805825242718,0,0.0,7.334730211
Lr,103,159,262,1.5436893203883495,0,-1.0,7.327788355
Lr,103,160,263,1.5533980582524272,0,0.0,7.323467578
Lr,103,161,264,1.5631067961165048,0,-1.0,7.31514647
Lr,103,162,265,1.5728155339805825,0,0.0,7.309598962
Lr,103,163,266,1.5825242718446602,0,-1.0,7.298056643
Lr,103,164,267,1.5922330097087378,0,0.0,7.289444783
Lr,103,165,268,1.6019417475728155,0,-1.0,7.276777291
Lr,103,166,269,1.6116504854368932,0,0.0,7.267211621
Lr,103,167,270,1.6213592233009708,0,-1.0,7.25479773
Lr,103,168,271,1.6310679611650485,0,0.0,7.245688889
Lr,103,169,272,1.6407766990291262,0,-1.0,7.233576386
Lr,103,170,273,1.6504854368932038,0,0.0,7.224988132
Lr,103,171,274,1.6601941747572815,0,-1.0,7.214606916
Lr,103,172,275,1.6699029126213591,0,0.0,7.207781098
Lr,103,173,276,1.6796116504854368,0,-1.0,7.196171667
Lr,103,174,277,1.6893203883495145,0,0.0,7.188139975
Lr,103,175,278,1.6990291262135921,0,-1.0,7.176606924
Lr,103,176,279,1.7087378640776698,0,0.0,7.168832262
Lr,103,177,280,1.7184466019417475,0,-1.0,7.156682225
Lr,103,178,281,1.7281553398058251,0,0.0,7.14850084
Lr,103,179,282,1.7378640776699028,0,-1.0,7.134591369
Lr,103,180,283,1.7475728155339805,0,0.0,7.124928544
Lr,103,181,284,1.7572815533980584,0,-1.0,7.110647856
Lr,103,182,285,1.766990291262136,0,0.0,7.100973772
Lr,103,183,286,1.7766990291262137,0,-1.0,7.087124392
Lr,103,184,287,1.7864077669902914,0,0.0,7.078042282
Lr,103,185,288,1.796116504854369,0,-1.0,7.057677396
Lr,103,186,289,1.8058252427184467,0,0.0,7.042060623
Lr,103,187,290,1.8155339805825244,0,-1.0,7.020423062
Lr,103,188,291,1.825242718446602,0,0.0,7.003483227
Lr,103,189,292,1.8349514563106797,0,-1.0,6.985631065
Lr,103,190,293,1.8446601941747574,0,0.0,6.971969358
Lr,103,191,294,1.854368932038835,0,-1.0,6.955123881
Lr,103,192,295,1.8640776699029127,0,0.0,6.941774793
Lr,103,193,296,1.8737864077669903,0,-1.0,6.925630662
Lr,103,194,297,1.883495145631068,0,0.0,6.912556286
Lr,103,195,298,1.8932038834951457,0,-1.0,6.899751383
Lr,103,196,299,1.9029126213592233,0,0.0,6.889520475
Lr,103,197,300,1.912621359223301,0,-1.0,6.87332871
Lr,103,198,301,1.9223300970873787,0,0.0,6.859412721
Lr,103,199,302,1.9320388349514563,0,-1.0,6.842941
Lr,103,200,303,1.941747572815534,0,0.0,6.828706406
Lr,103,201,304,1.9514563106796117,0,-1.0,6.812352444
Lr,103,202,305,1.9611650485436893,0,0.0,6.798263066
Lr,103,203,306,1.970873786407767,0,-1.0,6.782032167
Lr,103,204,307,1.9805825242718447,0,0.0,6.768118101
Lr,103,205,308,1.9902912621359223,0,-1.0,6.751845834
Lr,103,206,309,2.0,0,0.0,6.737890155
Lr,103,207,310,2.0097087378640777,0,-1.0,6.721162758
Lr,103,208,311,2.0194174757281553,0,0.0,6.706693723
Lr,103,209,312,2.029126213592233,0,-1.0,6.689290346
Lr,103,210,313,2.0388349514563107,0,0.0,6.674067508
Lr,103,211,314,2.0485436893203883,0,-1.0,6.656298102
Lr,103,212,315,2.058252427184466,0,0.0,6.640630121
Lr,103,213,316,2.0679611650485437,0,-1.0,6.622858715
Lr,103,214,317,2.0776699029126213,0,0.0,6.607115874
Lr,103,215,318,2.087378640776699,0,-1.0,6.589266912
Lr,103,216,319,2.0970873786407767,0,0.0,6.573389138
Lr,103,217,320,2.1067961165048543,0,-1.0,6.555287684
Lr,103,218,321,2.116504854368932,0,0.0,6.539122006
Lr,103,219,322,2.1262135922330097,0,-1.0,6.520263084
Lr,103,220,323,2.1359223300970873,0,0.0,6.50333122
Lr,103,221,324,2.145631067961165,0,-1.0,6.483349201
Lr,103,222,325,2.1553398058252426,0,0.0,6.465307732
Lr,103,224,327,2.174757281553398,0,0.0,6.426317771
Lr,103,226,329,2.1941747572815533,0,0.0,6.387615337
Lr,103,228,331,2.2135922330097086,0,0.0,6.349222876
Rf,104,139,243,1.3365384615384615,0,0.0,7.295638527
Rf,104,140,244,1.3461538461538463,0,1.0,7.305391816
Rf,104,141,245,1.3557692307692308,0,0.0,7.310809078
Rf,104,142,246,1.3653846153846154,0,1.0,7.319233008
Rf,104,143,247,1.375,0,0.0,7.323150733
Rf,104,144,248,1.3846153846153846,0,1.0,7.329979653
Rf,104,145,249,1.3942307692307692,0,0.0,7.332628382
Rf,104,146,250,1.4038461538461537,0,1.0,7.338045924
Rf,104,147,251,1.4134615384615385,0,0.0,7.339718594
Rf,104,148,252,1.4230769230769231,0,1.0,7.34399854
Rf,104,149,253,1.4326923076923077,0,0.0,7.344470573
Rf,104,150,254,1.4423076923076923,0,1.0,7.347410319
Rf,104,151,255,1.4519230769230769,0,0.0,7.345666231
Rf,104,152,256,1.4615384615384615,0,1.0,7.346297926
Rf,104,153,257,1.4711538461538463,0,0.0,7.342505366
Rf,104,154,258,1.4807692307692308,0,1.0,7.341034779
Rf,104,155,259,1.4903846153846154,0,0.0,7.336256946
Rf,104,156,260,1.5,0,1.0,7.333789758
Rf,104,157,261,1.5096153846153846,0,0.0,7.328334195
Rf,104,158,262,1.5192307692307692,0,1.0,7.325235454
Rf,104,159,263,1.5288461538461537,0,0.0,7.319350411
Rf,104,160,264,1.5384615384615385,0,1.0,7.315918966
Rf,104,161,265,1.5480769230769231,0,0.0,7.308633166
Rf,104,162,266,1.5576923076923077,0,1.0,7.303922342
Rf,104,163,267,1.5673076923076923,0,0.0,7.293170891
Rf,104,164,268,1.5769230769230769,0,1.0,7.28513669
Rf,104,165,269,1.5865384615384615,0,0.0,7.273275625
Rf,104,166,270,1.5961538461538463,0,1.0,7.264307767
Rf,104,167,271,1.6057692307692308,0,0.0,7.252583295
Rf,104,168,272,1.6153846153846154,0,1.0,7.243973022
Rf,104,169,273,1.625,0,0.0,7.232416908
Rf,104,170,274,1.6346153846153846,0,1.0,7.224208661
Rf,104,171,275,1.6442307692307692,0,0.0,7.213948124
Rf,104,172,276,1.6538461538461537,0,1.0,7.207145025
Rf,104,173,277,1.6634615384615385,0,0.0,7.195982097
Rf,104,174,278,1.6730769230769231,0,1.0,7.188373932
Rf,104,175,279,1.6826923076923077,0,0.0,7.177358502
Rf,104,176,280,1.6923076923076923,0,1.0,7.170087164
Rf,104,177,281,1.7019230769230769,0,0.0,7.158516427
Rf,104,178,282,1.7115384615384615,0,1.0,7.150893936
Rf,104,179,283,1.7211538461538463,0,0.0,7.137382279
Rf,104,180,284,1.7307692307692308,0,1.0,7.128088979
Rf,104,181,285,1.7403846153846154,0,0.0,7.114265835
Rf,104,182,286,1.75,0,1.0,7.105008056
Rf,104,183,287,1.7596153846153846,0,0.0,7.09181946
Rf,104,184,288,1.7692307692307692,0,1.0,7.083364785
Rf,104,185,289,1.7788461538461537,0,0.0,7.063724678
Rf,104,186,290,1.7884615384615385,0,1.0,7.048819569
Rf,104,187,291,1.7980769230769231,0,0.0,7.028011141
Rf,104,188,292,1.8076923076923077,0,1.0,7.011890774
Rf,104,189,293,1.8173076923076923,0,0.0,6.994406147
Rf,104,190,294,1.8269230769230769,0,1.0,6.98112116
Rf,104,191,295,1.8365384615384615,0,0.0,6.964830583
Rf,104,192,296,1.8461538461538463,0,1.0,6.95205423
Rf,104,193,297,1.8557692307692308,0,0.0,6.936549616
Rf,104,194,298,1.8653846153846154,0,1.0,6.924097087
Rf,104,195,299,1.875,0,0.0,6.913059231
Rf,104,196,300,1.8846153846153846,0,1.0,6.904554453
Rf,104,197,301,1.8942307692307692,0,0.0,6.888983857
Rf,104,198,302,1.9038461538461537,0,1.0,6.875677586
Rf,104,199,303,1.9134615384615385,0,0.0,6.859386551
Rf,104,200,304,1.9230769230769231,0,1.0,6.845298513
Rf,104,201,305,1.9326923076923077,0,0.0,6.829016105
Rf,104,202,306,1.9423076923076923,0,1.0,6.814903873
Rf,104,203,307,1.9519230769230769,0,0.0,6.798869518
Rf,104,204,308,1.9615384615384615,0,1.0,6.785067594
Rf,104,205,309,1.9711538461538463,0,0.0,6.769196861
Rf,104,206,310,1.9807692307692308,0,1.0,6.755616161
Rf,104,207,311,1.9903846153846154,0,0.0,6.73939926
Rf,104,208,312,2.0,0,1.0,6.725435984
Rf,104,209,313,2.0096153846153846,0,0.0,6.708563626
Rf,104,210,314,2.019230769230769,0,1.0,6.693871726
Rf,104,211,315,2.0288461538461537,0,0.0,6.67665607
Rf,104,212,316,2.0384615384615383,0,1.0,6.661541494
Rf,104,213,317,2.048076923076923,0,0.0,6.644311486
Rf,104,214,318,2.0576923076923075,0,1.0,6.629104704
Rf,104,215,319,2.0673076923076925,0,0.0,6.611817053
Rf,104,216,320,2.076923076923077,0,1.0,6.596482178
Rf,104,217,321,2.0865384615384617,0,0.0,6.578996826
Rf,104,218,322,2.0961538461538463,0,1.0,6.563405811
Rf,104,219,323,2.105769230769231,0,0.0,6.545143214
Rf,104,220,324,2.1153846153846154,0,1.0,6.528738778
Rf,104,221,325,2.125,0,0.0,6.509219132
Rf,104,222,326,2.1346153846153846,0,1.0,6.491546748
Rf,104,224,328,2.1538461538461537,0,1.0,6.453374863
Rf,104,226,330,2.173076923076923,0,1.0,6.415496991
Rf,104,228,332,2.1923076923076925,0,1.0,6.377880407
Rf,104,230,334,2.2115384615384617,0,1.0,6.340441323
Db,105,142,247,1.3523809523809525,0,0.0,7.285352543
Db,105,144,249,1.3714285714285714,0,0.0,7.297954337
Db,105,146,251,1.3904761904761904,0,0.0,7.308048633
Db,105,147,252,1.4,0,-1.0,7.310877563
Db,105,148,253,1.4095238095238096,0,0.0,7.31628864
Db,105,149,254,1.4190476190476191,0,-1.0,7.31796076
Db,105,150,255,1.4285714285714286,0,0.0,7.322039224
Db,105,151,256,1.438095238095238,0,-1.0,7.321474074
Db,105,152,257,1.4476190476190476,0,0.0,7.323183374
Db,105,153,258,1.457142857142857,0,-1.0,7.320502744
Db,105,154,259,1.4666666666666666,0,0.0,7.320009687
Db,105,155,260,1.4761904761904763,0,-1.0,7.316338012
Db,105,156,261,1.4857142857142858,0,0.0,7.314809705
Db,105,157,262,1.4952380952380953,0,-1.0,7.310561874
Db,105,158,263,1.5047619047619047,0,0.0,7.308467338
Db,105,159,264,1.5142857142857142,0,-1.0,7.303862208
Db,105,160,265,1.5238095238095237,0,0.0,7.30147337
Db,105,161,266,1.5333333333333334,0,-1.0,7.295345316
Db,105,162,267,1.542857142857143,0,0.0,7.291538884
Db,105,163,268,1.5523809523809524,0,-1.0,7.281752787
Db,105,164,269,1.561904761904762,0,0.0,7.274436524
Db,105,165,270,1.5714285714285714,0,-1.0,7.263445496
Db,105,166,271,1.5809523809523809,0,0.0,7.255106801
Db,105,167,272,1.5904761904761904,0,-1.0,7.244217651
Db,105,168,273,1.6,0,0.0,7.236198941
Db,105,169,274,1.6095238095238096,0,-1.0,7.225361555
Db,105,170,275,1.619047619047619,0,0.0,7.217629091
Db,105,171,276,1.6285714285714286,0,-1.0,7.207435149
Db,105,172,277,1.638095238095238,0,0.0,7.20056304
Db,105,173,278,1.6476190476190475,0,-1.0,7.190031906
Db,105,174,279,1.6571428571428573,0,0.0,7.183024151
Db,105,175,280,1.6666666666666667,0,-1.0,7.172685439
Db,105,176,281,1.6761904761904762,0,0.0,7.166069399
Db,105,177,282,1.6857142857142857,0,-1.0,7.15516477
Db,105,178,283,1.6952380952380952,0,0.0,7.148178657
Db,105,179,284,1.7047619047619047,0,-1.0,7.135430585
Db,105,180,285,1.7142857142857142,0,0.0,7.126849333
Db,105,181,286,1.723809523809524,0,-1.0,7.113634965
Db,105,182,287,1.7333333333333334,0,0.0,7.104925742
Db,105,183,288,1.7428571428571429,0,-1.0,7.092010816
Db,105,184,289,1.7523809523809524,0,0.0,7.083769651
Db,105,185,290,1.7619047619047619,0,-1.0,7.064630914
Db,105,186,291,1.7714285714285714,0,0.0,7.050164735
Db,105,187,292,1.7809523809523808,0,-1.0,7.030758134
Db,105,188,293,1.7904761904761906,0,0.0,7.015490249
Db,105,189,294,1.8,0,-1.0,6.998530714
Db,105,190,295,1.8095238095238095,0,0.0,6.985026081
Db,105,191,296,1.819047619047619,0,-1.0,6.969084561
Db,105,192,297,1.8285714285714285,0,0.0,6.956302697
Db,105,193,298,1.838095238095238,0,-1.0,6.944091369
Db,105,194,299,1.8476190476190477,0,0.0,6.934656913
Db,105,195,300,1.8571428571428572,0,-1.0,6.92218787
Db,105,196,301,1.8666666666666667,0,0.0,6.912111163
Db,105,197,302,1.8761904761904762,0,-1.0,6.897081993
Db,105,198,303,1.8857142857142857,0,0.0,6.884275205
Db,105,199,304,1.8952380952380952,0,-1.0,6.868412464
Db,105,200,305,1.9047619047619047,0,0.0,6.854713656
Db,105,201,306,1.9142857142857144,0,-1.0,6.838567317
Db,105,202,307,1.9238095238095239,0,0.0,6.824548114
Db,105,203,308,1.9333333333333333,0,-1.0,6.808828523
Db,105,204,309,1.9428571428571428,0,0.0,6.795303935
Db,105,205,310,1.9523809523809523,0,-1.0,6.780061868
Db,105,206,311,1.9619047619047618,0,0.0,6.767106871
Db,105,207,312,1.9714285714285715,0,-1.0,6.75140076
Db,105,208,313,1.980952380952381,0,0.0,6.737964042
Db,105,209,314,1.9904761904761905,0,-1.0,6.721551169
Db,105,210,315,2.0,0,0.0,6.70732653
Db,105,211,316,2.0095238095238095,0,-1.0,6.690510364
Db,105,212,317,2.019047619047619,0,0.0,6.675791356
Db,105,213,318,2.0285714285714285,0,-1.0,6.658976362
Db,105,214,319,2.038095238095238,0,0.0,6.644166013
Db,105,215,320,2.0476190476190474,0,-1.0,6.627419416
Db,105,216,321,2.057142857142857,0,0.0,6.612589302
Db,105,217,322,2.066666666666667,0,-1.0,6.595786276
Db,105,218,323,2.0761904761904764,0,0.0,6.580819885
Db,105,219,324,2.085714285714286,0,-1.0,6.563249824
Db,105,220,325,2.0952380952380953,0,0.0,6.547457874
Db,105,221,326,2.104761904761905,0,-1.0,6.528563601
Db,105,222,327,2.1142857142857143,0,0.0,6.511417939
Db,105,223,328,2.123809523809524,0,-1.0,6.491971021
Db,105,224,329,2.1333333333333333,0,0.0,6.474264459
Db,105,225,330,2.142857142857143,0,-1.0,6.454979555
Db,105,226,331,2.1523809523809523,0,0.0,6.437447994
Db,105,227,332,2.1619047619047618,0,-1.0,6.418298744
Db,105,228,333,2.1714285714285713,0,0.0,6.400946237
Db,105,229,334,2.1809523809523808,0,-1.0,6.381851117
Db,105,230,335,2.1904761904761907,0,0.0,6.364632316
Db,105,232,337,2.2095238095238097,0,0.0,6.327290294
Db,105,244,349,2.323809523809524,0,0.0,6.095490209
Sg,106,143,249,1.349056603773585,0,0.0,7.262076767
Sg,106,145,251,1.3679245283018868,0,0.0,7.275156673
Sg,106,146,252,1.3773584905660377,0,1.0,7.282471091
Sg,106,147,253,1.3867924528301887,0,0.0,7.286302368
Sg,106,148,254,1.3962264150943395,0,1.0,7.292692059
Sg,106,149,255,1.4056603773584906,0,0.0,7.29541069
Sg,106,150,256,1.4150943396226414,0,1.0,7.30047598
Sg,106,151,257,1.4245283018867925,0,0.0,7.300946494
Sg,106,152,258,1.4339622641509433,0,1.0,7.303592027
Sg,106,153,259,1.4433962264150944,0,0.0,7.301997988
Sg,106,154,260,1.4528301886792452,0,1.0,7.302458354
Sg,106,155,261,1.4622641509433962,0,0.0,7.299923908
Sg,106,156,262,1.471698113207547,0,1.0,7.299366588
Sg,106,157,263,1.4811320754716981,0,0.0,7.296286817
Sg,106,158,264,1.490566037735849,0,1.0,7.295158659
Sg,106,159,265,1.5,0,0.0,7.291715453
Sg,106,160,266,1.509433962264151,0,1.0,7.290253887
Sg,106,161,267,1.5188679245283019,0,0.0,7.285340697
Sg,106,162,268,1.528301886792453,0,1.0,7.282497246
Sg,106,163,269,1.5377358490566038,0,0.0,7.273694721
Sg,106,164,270,1.5471698113207548,0,1.0,7.267116315
Sg,106,165,271,1.5566037735849056,0,0.0,7.25714138
Sg,106,166,272,1.5660377358490567,0,1.0,7.249578592
Sg,106,167,273,1.5754716981132075,0,0.0,7.239529374
Sg,106,168,274,1.5849056603773586,0,1.0,7.232108577
Sg,106,169,275,1.5943396226415094,0,0.0,7.221907455
Sg,106,170,276,1.6037735849056605,0,1.0,7.214570674
Sg,106,171,277,1.6132075471698113,0,0.0,7.204344545
Sg,106,172,278,1.6226415094339623,0,1.0,7.197306327
Sg,106,173,279,1.6320754716981132,0,0.0,7.187218369
Sg,106,174,280,1.6415094339622642,0,1.0,7.180623975
Sg,106,175,281,1.650943396226415,0,0.0,7.170846125
Sg,106,176,282,1.6603773584905661,0,1.0,7.164770486
Sg,106,177,283,1.669811320754717,0,0.0,7.154482357
Sg,106,178,284,1.679245283018868,0,1.0,7.148083577
Sg,106,179,285,1.6886792452830188,0,0.0,7.135804032
Sg,106,180,286,1.6981132075471699,0,1.0,7.127642203
Sg,106,181,287,1.7075471698113207,0,0.0,7.114978878
Sg,106,182,288,1.7169811320754718,0,1.0,7.106761295
Sg,106,183,289,1.7264150943396226,0,0.0,7.094510246
Sg,106,184,290,1.7358490566037736,0,1.0,7.086870517
Sg,106,185,291,1.7452830188679245,0,0.0,7.068496423
Sg,106,186,292,1.7547169811320755,0,1.0,7.054731075
Sg,106,187,293,1.7641509433962264,0,0.0,7.037194348
Sg,106,188,294,1.7735849056603774,0,1.0,7.023247554
Sg,106,189,295,1.7830188679245282,0,0.0,7.006577434
Sg,106,190,296,1.7924528301886793,0,1.0,6.992624091
Sg,106,191,297,1.8018867924528301,0,0.0,6.977110508
Sg,106,192,298,1.8113207547169812,0,1.0,6.964403869
Sg,106,193,299,1.820754716981132,0,0.0,6.955518462
Sg,106,194,300,1.830188679245283,0,1.0,6.94913634
Sg,106,195,301,1.8396226415094339,0,0.0,6.935178286
Sg,106,196,302,1.849056603773585,0,1.0,6.923473152
Sg,106,197,303,1.8584905660377358,0,0.0,6.908919875
Sg,106,198,304,1.8679245283018868,0,1.0,6.896547757
Sg,106,199,305,1.8773584905660377,0,0.0,6.881104843
Sg,106,200,306,1.8867924528301887,0,1.0,6.867787108
Sg,106,201,307,1.8962264150943395,0,0.0,6.851815296
Sg,106,202,308,1.9056603773584906,0,1.0,6.837927604
Sg,106,203,309,1.9150943396226414,0,0.0,6.822450968
Sg,106,204,310,1.9245283018867925,0,1.0,6.809132613
Sg,106,205,311,1.9339622641509433,0,0.0,6.794371476
Sg,106,206,312,1.9433962264150944,0,1.0,6.78189541
Sg,106,207,313,1.9528301886792452,0,0.0,6.766613895
Sg,106,208,314,1.9622641509433962,0,1.0,6.753617994
Sg,106,209,315,1.971698113207547,0,0.0,6.737600527
Sg,106,210,316,1.9811320754716981,0,1.0,6.723779434
Sg,106,211,317,1.990566037735849,0,0.0,6.707337956
Sg,106,212,318,2.0,0,1.0,6.692989893
Sg,106,213,319,2.009433962264151,0,0.0,6.676563301
Sg,106,214,320,2.018867924528302,0,1.0,6.662123059
Sg,106,215,321,2.0283018867924527,0,0.0,6.645859343
Sg,106,216,322,2.0377358490566038,0,1.0,6.631476398
Sg,106,217,323,2.047169811320755,0,0.0,6.615269164
Sg,106,218,324,2.056603773584906,0,1.0,6.600841753
Sg,106,219,325,2.0660377358490565,0,0.0,6.583904314
Sg,106,220,326,2.0754716981132075,0,1.0,6.568665798
Sg,106,221,327,2.0849056603773586,0,0.0,6.55033337
Sg,106,222,328,2.0943396226415096,0,1.0,6.53365189
Sg,106,223,329,2.1037735849056602,0,0.0,6.51481831
Sg,106,224,330,2.1132075471698113,0,1.0,6.497612245
Sg,106,225,331,2.1226415094339623,0,0.0,6.478944335
Sg,106,226,332,2.1320754716981134,0,1.0,6.461904907
Sg,106,227,333,2.141509433962264,0,0.0,6.44335615
Sg,106,228,334,2.150943396226415,0,1.0,6.426470398
Sg,106,229,335,2.160377358490566,0,0.0,6.407965675
Sg,106,230,336,2.169811320754717,0,1.0,6.391197339
Sg,106,232,338,2.188679245283019,0,1.0,6.354834021
Sg,106,244,350,2.30188679245283,0,1.0,6.125322423
Bh,107,148,255,1.3831775700934579,0,0.0,7.26164949
Bh,107,150,257,1.4018691588785046,0,0.0,7.271676144
Bh,107,151,258,1.411214953271028,0,-1.0,7.273164756
Bh,107,152,259,1.4205607476635513,0,0.0,7.277017907
Bh,107,153,260,1.4299065420560748,0,-1.0,7.276372412
Bh,107,154,261,1.439252336448598,0,0.0,7.277971046
Bh,107,155,262,1.4485981308411215,0,-1.0,7.276384771
Bh,107,156,263,1.4579439252336448,0,0.0,7.276937681
Bh,107,157,264,1.4672897196261683,0,-1.0,7.27489942
Bh,107,158,265,1.4766355140186915,0,0.0,7.274925091
Bh,107,159,266,1.485981308411215,0,-1.0,7.272619602
Bh,107,160,267,1.4953271028037383,0,0.0,7.272347629
Bh,107,161,268,1.5046728971962617,0,-1.0,7.268478545
Bh,107,162,269,1.514018691588785,0,0.0,7.266672257
Bh,107,163,270,1.5233644859813085,0,-1.0,7.25880857
Bh,107,164,271,1.5327102803738317,0,0.0,7.253105815
Bh,107,165,272,1.5420560747663552,0,-1.0,7.243999243
Bh,107,166,273,1.5514018691588785,0,0.0,7.237186396
Bh,107,167,274,1.560747663551402,0,-1.0,7.227992095
Bh,107,168,275,1.5700934579439252,0,0.0,7.221260491
Bh,107,169,276,1.5794392523364487,0,-1.0,7.211809362
Bh,107,170,277,1.588785046728972,0,0.0,7.205033668
Bh,107,171,278,1.5981308411214954,0,-1.0,7.195480978
Bh,107,172,279,1.6074766355140186,0,0.0,7.188943452
Bh,107,173,280,1.6168224299065421,0,-1.0,7.179531143
Bh,107,174,281,1.6261682242990654,0,0.0,7.173509338
Bh,107,175,282,1.6355140186915889,0,-1.0,7.164087993
Bh,107,176,283,1.644859813084112,0,0.0,7.158326428
Bh,107,177,284,1.6542056074766356,0,-1.0,7.148725486
Bh,107,178,285,1.6635514018691588,0,0.0,7.142965551
Bh,107,179,286,1.6728971962616823,0,-1.0,7.131504934
Bh,107,180,287,1.6822429906542056,0,0.0,7.124085791
Bh,107,181,288,1.691588785046729,0,-1.0,7.112061385
Bh,107,182,289,1.7009345794392523,0,0.0,7.104385149
Bh,107,183,290,1.7102803738317758,0,-1.0,7.092517048
Bh,107,184,291,1.719626168224299,0,0.0,7.08515423
Bh,107,185,292,1.7289719626168225,0,-1.0,7.067292524
Bh,107,186,293,1.7383177570093458,0,0.0,7.053933177
Bh,107,187,294,1.7476635514018692,0,-1.0,7.03621481
Bh,107,188,295,1.7570093457943925,0,0.0,7.022108081
Bh,107,189,296,1.766355140186916,0,-1.0,7.006679074
Bh,107,190,297,1.7757009345794392,0,0.0,6.994024902
Bh,107,191,298,1.7850467289719627,0,-1.0,6.981476634
Bh,107,192,299,1.794392523364486,0,0.0,6.971598977
Bh,107,193,300,1.8037383177570094,0,-1.0,6.96086074
Bh,107,194,301,1.8130841121495327,0,0.0,6.952516797
Bh,107,195,302,1.8224299065420562,0,-1.0,6.939058454
Bh,107,196,303,1.8317757009345794,0,0.0,6.927841815
Bh,107,197,304,1.841121495327103,0,-1.0,6.913882293
Bh,107,198,305,1.8504672897196262,0,0.0,6.902111741
Bh,107,199,306,1.8598130841121496,0,-1.0,6.887185908
Bh,107,200,307,1.8691588785046729,0,0.0,6.874416221
Bh,107,201,308,1.8785046728971964,0,-1.0,6.858744068
Bh,107,202,309,1.8878504672897196,0,0.0,6.845205123
Bh,107,203,310,1.897196261682243,0,-1.0,6.829845619
Bh,107,204,311,1.9065420560747663,0,0.0,6.816723762
Bh,107,205,312,1.9158878504672898,0,-1.0,6.802481837
Bh,107,206,313,1.925233644859813,0,0.0,6.79058492
Bh,107,207,314,1.9345794392523366,0,-1.0,6.775812201
Bh,107,208,315,1.9439252336448598,0,0.0,6.76334706
Bh,107,209,316,1.9532710280373833,0,-1.0,6.747817554
Bh,107,210,317,1.9626168224299065,0,0.0,6.734515845
Bh,107,211,318,1.97196261682243,0,-1.0,6.718511733
Bh,107,212,319,1.9813084112149533,0,0.0,6.704644013
Bh,107,213,320,1.9906542056074767,0,-1.0,6.688635347
Bh,107,214,321,2.0,0,0.0,6.674664667
Bh,107,215,322,2.0093457943925235,0,-1.0,6.658856929
Bh,107,216,323,2.0186915887850465,0,0.0,6.644986015
Bh,107,217,324,2.02803738317757,0,-1.0,6.62930708
Bh,107,218,325,2.0373831775700935,0,0.0,6.615465089
Bh,107,219,326,2.046728971962617,0,-1.0,6.599060761
Bh,107,220,327,2.05607476635514,0,0.0,6.584410517
Bh,107,221,328,2.0654205607476634,0,-1.0,6.56660929
Bh,107,222,329,2.074766355140187,0,0.0,6.550506678
Bh,107,223,330,2.0841121495327104,0,-1.0,6.532153403
Bh,107,224,331,2.0934579439252334,0,0.0,6.51546465
Bh,107,225,332,2.102803738317757,0,-1.0,6.497307982
Bh,107,226,333,2.1121495327102804,0,0.0,6.480803105
Bh,107,227,334,2.121495327102804,0,-1.0,6.462810901
Bh,107,228,335,2.130841121495327,0,0.0,6.446484854
Bh,107,229,336,2.1401869158878504,0,-1.0,6.428591503
Bh,107,230,337,2.149532710280374,0,0.0,6.412409493
Bh,107,231,338,2.1588785046728973,0,-1.0,6.393843151
Bh,107,232,339,2.1682242990654204,0,0.0,6.377064912
Bh,107,244,351,2.2803738317757007,0,0.0,6.150775718
Bh,107,246,353,2.2990654205607477,0,0.0,6.11600496
Hs,108,149,257,1.3796296296296295,0,0.0,7.239486739
Hs,108,150,258,1.3888888888888888,0,1.0,7.246792481
Hs,108,151,259,1.3981481481481481,0,0.0,7.24913695
Hs,108,152,260,1.4074074074074074,0,1.0,7.254035281
Hs,108,153,261,1.4166666666666667,0,0.0,7.254306598
Hs,108,154,262,1.4259259259259258,0,1.0,7.257010573
Hs,108,155,263,1.4351851851851851,0,0.0,7.256396741
Hs,108,156,264,1.4444444444444444,0,1.0,7.258082742
Hs,108,157,265,1.4537037037037037,0,0.0,7.25703077
Hs,108,158,266,1.462962962962963,0,1.0,7.258154609
Hs,108,159,267,1.4722222222222223,0,0.0,7.25683282
Hs,108,160,268,1.4814814814814814,0,1.0,7.25759719
Hs,108,161,269,1.4907407407407407,0,0.0,7.25479577
Hs,108,162,270,1.5,0,1.0,7.254050096
Hs,108,163,271,1.5092592592592593,0,0.0,7.247103631
Hs,108,164,272,1.5185185185185186,0,1.0,7.24225554
Hs,108,165,273,1.5277777777777777,0,0.0,7.234173549
Hs,108,166,274,1.537037037037037,0,1.0,7.228266588
Hs,108,167,275,1.5462962962962963,0,0.0,7.219961727
Hs,108,168,276,1.5555555555555556,0,1.0,7.213954775
Hs,108,169,277,1.5648148148148149,0,0.0,7.20520939
Hs,108,170,278,1.5740740740740742,0,1.0,7.198952201
Hs,108,171,279,1.5833333333333333,0,0.0,7.189937018
Hs,108,172,280,1.5925925925925926,0,1.0,7.183766457
Hs,108,173,281,1.6018518518518519,0,0.0,7.174873456
Hs,108,174,282,1.6111111111111112,0,1.0,7.169269752
Hs,108,175,283,1.6203703703703705,0,0.0,7.160113092
Hs,108,176,284,1.6296296296296295,0,1.0,7.154574725
Hs,108,177,285,1.6388888888888888,0,0.0,7.145619505
Hs,108,178,286,1.6481481481481481,0,1.0,7.14045757
Hs,108,179,287,1.6574074074074074,0,0.0,7.129525784
Hs,108,180,288,1.6666666666666667,0,1.0,7.122561778
Hs,108,181,289,1.6759259259259258,0,0.0,7.111123567
Hs,108,182,290,1.6851851851851851,0,1.0,7.10393699
Hs,108,183,291,1.6944444444444444,0,0.0,7.092835636
Hs,108,184,292,1.7037037037037037,0,1.0,7.086131627
Hs,108,185,293,1.712962962962963,0,0.0,7.069066096
Hs,108,186,294,1.7222222222222223,0,1.0,7.056395323
Hs,108,187,295,1.7314814814814814,0,0.0,7.038879658
Hs,108,188,296,1.7407407407407407,0,1.0,7.024994588
Hs,108,189,297,1.75,0,0.0,7.01079997
Hs,108,190,298,1.7592592592592593,0,1.0,6.999437896
Hs,108,191,299,1.7685185185185186,0,0.0,6.989833816
Hs,108,192,300,1.7777777777777777,0,1.0,6.982765063
Hs,108,193,301,1.787037037037037,0,0.0,6.970115455
Hs,108,194,302,1.7962962962962963,0,1.0,6.959752255
Hs,108,195,303,1.8055555555555556,0,0.0,6.946722904
Hs,108,196,304,1.8148148148148149,0,1.0,6.935924582
Hs,108,197,305,1.8240740740740742,0,0.0,6.922482613
Hs,108,198,306,1.8333333333333333,0,1.0,6.911237879
Hs,108,199,307,1.8425925925925926,0,0.0,6.896800463
Hs,108,200,308,1.8518518518518519,0,1.0,6.884550146
Hs,108,201,309,1.8611111111111112,0,0.0,6.869225097
Hs,108,202,310,1.8703703703703705,0,1.0,6.856081723
Hs,108,203,311,1.8796296296296295,0,0.0,6.840822077
Hs,108,204,312,1.8888888888888888,0,1.0,6.827879035
Hs,108,205,313,1.8981481481481481,0,0.0,6.814025006
Hs,108,206,314,1.9074074074074074,0,1.0,6.802576376
Hs,108,207,315,1.9166666666666667,0,0.0,6.788226362
Hs,108,208,316,1.9259259259259258,0,1.0,6.776206294
Hs,108,209,317,1.9351851851851851,0,0.0,6.761106164
Hs,108,210,318,1.9444444444444444,0,1.0,6.748265421
Hs,108,211,319,1.9537037037037037,0,0.0,6.732683169
Hs,108,212,320,1.962962962962963,0,1.0,6.719280109
Hs,108,213,321,1.9722222222222223,0,0.0,6.703672209
Hs,108,214,322,1.9814814814814814,0,1.0,6.690153717
Hs,108,215,323,1.9907407407407407,0,0.0,6.674745003
Hs,108,216,324,2.0,0,1.0,6.661329164
Hs,108,217,325,2.009259259259259,0,0.0,6.646082591
Hs,108,218,326,2.0185185185185186,0,1.0,6.632730322
Hs,108,219,327,2.0277777777777777,0,0.0,6.616787529
Hs,108,220,328,2.037037037037037,0,1.0,6.602654091
Hs,108,221,329,2.0462962962962963,0,0.0,6.585308201
Hs,108,222,330,2.0555555555555554,0,1.0,6.569708773
Hs,108,223,331,2.064814814814815,0,0.0,6.551882918
Hs,108,224,332,2.074074074074074,0,1.0,6.535758084
Hs,108,225,333,2.0833333333333335,0,0.0,6.518133514
Hs,108,226,334,2.0925925925925926,0,1.0,6.502183769
Hs,108,227,335,2.1018518518518516,0,0.0,6.484712991
Hs,108,228,336,2.111111111111111,0,1.0,6.468911714
Hs,108,229,337,2.1203703703703702,0,0.0,6.451569356
Hs,108,230,338,2.1296296296296298,0,1.0,6.435913805
Hs,108,231,339,2.138888888888889,0,0.0,6.417901935
Hs,108,232,340,2.1481481481481484,0,1.0,6.401621871
Hs,108,234,342,2.1666666666666665,0,1.0,6.364219632
Hs,108,246,354,2.2777777777777777,0,1.0,6.144088234
Mt,109,152,261,1.3944954128440368,0,0.0,7.222848337
Mt,109,154,263,1.4128440366972477,0,0.0,7.22731451
Mt,109,156,265,1.4311926605504588,0,0.0,7.230106389
Mt,109,157,266,1.4403669724770642,0,-1.0,7.230037752
Mt,109,158,267,1.4495412844036697,0,0.0,7.232272404
Mt,109,159,268,1.4587155963302751,0,-1.0,7.232086257
Mt,109,160,269,1.4678899082568808,0,0.0,7.23406877
Mt,109,161,270,1.4770642201834863,0,-1.0,7.23233697
Mt,109,162,271,1.4862385321100917,0,0.0,7.232699225
Mt,109,163,272,1.4954128440366972,0,-1.0,7.226844893
Mt,109,164,273,1.5045871559633028,0,0.0,7.223077403
Mt,109,165,274,1.5137614678899083,0,-1.0,7.216035701
Mt,109,166,275,1.5229357798165137,0,0.0,7.211105164
Mt,109,167,276,1.5321100917431192,0,-1.0,7.203868272
Mt,109,168,277,1.5412844036697249,0,0.0,7.198820765
Mt,109,169,278,1.5504587155963303,0,-1.0,7.191042119
Mt,109,170,279,1.5596330275229358,0,0.0,7.185621344
Mt,109,171,280,1.5688073394495412,0,-1.0,7.177816339
Mt,109,172,281,1.5779816513761469,0,0.0,7.172724883
Mt,109,173,282,1.5871559633027523,0,-1.0,7.164841323
Mt,109,174,283,1.5963302752293578,0,0.0,7.160080926
Mt,109,175,284,1.6055045871559632,0,-1.0,7.151291616
Mt,109,176,285,1.614678899082569,0,0.0,7.145903505
Mt,109,177,286,1.6238532110091743,0,-1.0,7.137660147
Mt,109,178,287,1.6330275229357798,0,0.0,7.133052899
Mt,109,179,288,1.6422018348623852,0,-1.0,7.122967344
Mt,109,180,289,1.651376146788991,0,0.0,7.116750581
Mt,109,181,290,1.6605504587155964,0,-1.0,7.106120038
Mt,109,182,291,1.6697247706422018,0,0.0,7.099595897
Mt,109,183,292,1.6788990825688073,0,-1.0,7.088850599
Mt,109,184,293,1.688073394495413,0,0.0,7.082340802
Mt,109,185,294,1.6972477064220184,0,-1.0,7.065801037
Mt,109,186,295,1.7064220183486238,0,0.0,7.053503681
Mt,109,187,296,1.7155963302752293,0,-1.0,7.036090351
Mt,109,188,297,1.724770642201835,0,0.0,7.02253071
Mt,109,189,298,1.7339449541284404,0,-1.0,7.008660923
Mt,109,190,299,1.7431192660550459,0,0.0,6.997924077
Mt,109,191,300,1.7522935779816513,0,-1.0,6.98646278
Mt,109,192,301,1.761467889908257,0,0.0,6.977674771
Mt,109,193,302,1.7706422018348624,0,-1.0,6.964580017
Mt,109,194,303,1.7798165137614679,0,0.0,6.954023112
Mt,109,195,304,1.7889908256880733,0,-1.0,6.944879845
Mt,109,196,305,1.798165137614679,0,0.0,6.938074852
Mt,109,197,306,1.8073394495412844,0,-1.0,6.92513216
Mt,109,198,307,1.81651376146789,0,0.0,6.914380642
Mt,109,199,308,1.8256880733944953,0,-1.0,6.90053649
Mt,109,200,309,1.834862385321101,0,0.0,6.888860152
Mt,109,201,310,1.8440366972477065,0,-1.0,6.874042181
Mt,109,202,311,1.853211009174312,0,0.0,6.861381971
Mt,109,203,312,1.8623853211009174,0,-1.0,6.846160843
Mt,109,204,313,1.871559633027523,0,0.0,6.833255141
Mt,109,205,314,1.8807339449541285,0,-1.0,6.819773608
Mt,109,206,315,1.889908256880734,0,0.0,6.808718394
Mt,109,207,316,1.8990825688073394,0,-1.0,6.794824731
Mt,109,208,317,1.908256880733945,0,0.0,6.78328883
Mt,109,209,318,1.9174311926605505,0,-1.0,6.768678764
Mt,109,210,319,1.926605504587156,0,0.0,6.756365498
Mt,109,211,320,1.9357798165137614,0,-1.0,6.741259716
Mt,109,212,321,1.944954128440367,0,0.0,6.728380994
Mt,109,213,322,1.9541284403669725,0,-1.0,6.713232301
Mt,109,214,323,1.963302752293578,0,0.0,6.700232619
Mt,109,215,324,1.9724770642201834,0,-1.0,6.685272907
Mt,109,216,325,1.981651376146789,0,0.0,6.672379578
Mt,109,217,326,1.9908256880733946,0,-1.0,6.657563874
Mt,109,218,327,2.0,0,0.0,6.644730239
Mt,109,219,328,2.0091743119266057,0,-1.0,6.629206229
Mt,109,220,329,2.018348623853211,0,0.0,6.615587395
Mt,109,221,330,2.0275229357798166,0,-1.0,6.598703212
Mt,109,222,331,2.036697247706422,0,0.0,6.583654441
Mt,109,223,332,2.0458715596330275,0,-1.0,6.566239666
Mt,109,224,333,2.055045871559633,0,0.0,6.550592742
Mt,109,225,334,2.0642201834862384,0,-1.0,6.533395988
Mt,109,226,335,2.073394495412844,0,0.0,6.517911767
Mt,109,227,336,2.0825688073394497,0,-1.0,6.500940185
Mt,109,228,337,2.091743119266055,0,0.0,6.485649285
Mt,109,229,338,2.1009174311926606,0,-1.0,6.468833849
Mt,109,230,339,2.110091743119266,0,0.0,6.453692345
Mt,109,231,340,2.1192660550458715,0,-1.0,6.436176571
Mt,109,232,341,2.128440366972477,0,0.0,6.420355765
Mt,109,234,343,2.146788990825688,0,0.0,6.384014085
Mt,109,242,351,2.220183486238532,0,0.0,6.237565071
Mt,109,244,353,2.238532110091743,0,0.0,6.202531524
Mt,109,246,355,2.256880733944954,0,0.0,6.168110673
Mt,109,250,359,2.293577981651376,0,0.0,6.099215758
Ds,110,153,263,1.3909090909090909,0,0.0,7.196864114
Ds,110,155,265,1.4090909090909092,0,0.0,7.202211834
Ds,110,156,266,1.4181818181818182,0,1.0,7.20581865
Ds,110,157,267,1.4272727272727272,0,0.0,7.206664667
Ds,110,158,268,1.4363636363636363,0,1.0,7.209941
Ds,110,159,269,1.4454545454545455,0,0.0,7.210702628
Ds,110,160,270,1.4545454545454546,0,1.0,7.213716189
Ds,110,161,271,1.4636363636363636,0,0.0,7.213020458
Ds,110,162,272,1.4727272727272727,0,1.0,7.214457055
Ds,110,163,273,1.481818181818182,0,0.0,7.209615425
Ds,110,164,274,1.490909090909091,0,1.0,7.206849763
Ds,110,165,275,1.5,0,0.0,7.200992807
Ds,110,166,276,1.509090909090909,0,1.0,7.197182562
Ds,110,167,277,1.518181818181818,0,0.0,7.191058072
Ds,110,168,278,1.5272727272727273,0,1.0,7.187014903
Ds,110,169,279,1.5363636363636364,0,0.0,7.180184659
Ds,110,170,280,1.5454545454545454,0,1.0,7.175583014
Ds,110,171,281,1.5545454545454545,0,0.0,7.168892833
Ds,110,172,282,1.5636363636363637,0,1.0,7.164786734
Ds,110,173,283,1.5727272727272728,0,0.0,7.157761958
Ds,110,174,284,1.5818181818181818,0,1.0,7.153696451
Ds,110,175,285,1.5909090909090908,0,0.0,7.145182968
Ds,110,176,286,1.6,0,1.0,7.139855755
Ds,110,177,287,1.6090909090909091,0,0.0,7.132303481
Ds,110,178,288,1.6181818181818182,0,1.0,7.128231382
Ds,110,179,289,1.6272727272727272,0,0.0,7.118720623
Ds,110,180,290,1.6363636363636365,0,1.0,7.112982221
Ds,110,181,291,1.6454545454545455,0,0.0,7.103109155
Ds,110,182,292,1.6545454545454545,0,1.0,7.097198599
Ds,110,183,293,1.6636363636363636,0,0.0,7.087186526
Ds,110,184,294,1.6727272727272726,0,1.0,7.081246639
Ds,110,185,295,1.6818181818181819,0,0.0,7.065536027
Ds,110,186,296,1.690909090909091,0,1.0,7.053914449
Ds,110,187,297,1.7,0,0.0,7.036978421
Ds,110,188,298,1.709090909090909,0,1.0,7.024115161
Ds,110,189,299,1.7181818181818183,0,0.0,7.010530388
Ds,110,190,300,1.7272727272727273,0,1.0,7.000377213
Ds,110,191,301,1.7363636363636363,0,0.0,6.987076259
Ds,110,192,302,1.7454545454545454,0,1.0,6.97658553
Ds,110,193,303,1.7545454545454546,0,0.0,6.963033228
Ds,110,194,304,1.7636363636363637,0,1.0,6.952268638
Ds,110,195,305,1.7727272727272727,0,0.0,6.946812626
Ds,110,196,306,1.7818181818181817,0,1.0,6.943802732
Ds,110,197,307,1.790909090909091,0,0.0,6.931300651
Ds,110,198,308,1.8,0,1.0,6.920984097
Ds,110,199,309,1.809090909090909,0,0.0,6.907698803
Ds,110,200,310,1.8181818181818181,0,1.0,6.896562384
Ds,110,201,311,1.8272727272727274,0,0.0,6.882290074
Ds,110,202,312,1.8363636363636364,0,1.0,6.870151526
Ds,110,203,313,1.8454545454545455,0,0.0,6.854984
Ds,110,204,314,1.8545454545454545,0,1.0,6.842130643
Ds,110,205,315,1.8636363636363635,0,0.0,6.828918429
Ds,110,206,316,1.8727272727272728,0,1.0,6.818153972
Ds,110,207,317,1.8818181818181818,0,0.0,6.80463765
Ds,110,208,318,1.8909090909090909,0,1.0,6.79350723
Ds,110,209,319,1.9,0,0.0,6.779336871
Ds,110,210,320,1.9090909090909092,0,1.0,6.767500813
Ds,110,211,321,1.9181818181818182,0,0.0,6.752861274
Ds,110,212,322,1.9272727272727272,0,1.0,6.740496432
Ds,110,213,323,1.9363636363636363,0,0.0,6.725793195
Ds,110,214,324,1.9454545454545455,0,1.0,6.713298293
Ds,110,215,325,1.9545454545454546,0,0.0,6.698726751
Ds,110,216,326,1.9636363636363636,0,1.0,6.686295015
Ds,110,217,327,1.9727272727272727,0,0.0,6.67181189
Ds,110,218,328,1.981818181818182,0,1.0,6.659398659
Ds,110,219,329,1.990909090909091,0,0.0,6.644221003
Ds,110,220,330,2.0,0,1.0,6.631044206
Ds,110,221,331,2.0090909090909093,0,0.0,6.614549127
Ds,110,222,332,2.018181818181818,0,1.0,6.599978313
Ds,110,223,333,2.0272727272727273,0,0.0,6.583019787
Ds,110,224,334,2.036363636363636,0,1.0,6.567895278
Ds,110,225,335,2.0454545454545454,0,0.0,6.551142872
Ds,110,226,336,2.0545454545454547,0,1.0,6.536140375
Ds,110,227,337,2.0636363636363635,0,0.0,6.519619166
Ds,110,228,338,2.0727272727272728,0,1.0,6.504790044
Ds,110,229,339,2.081818181818182,0,0.0,6.488423021
Ds,110,230,340,2.090909090909091,0,1.0,6.473717579
Ds,110,231,341,2.1,0,0.0,6.456698809
Ds,110,232,342,2.109090909090909,0,1.0,6.44133838
Ds,110,233,343,2.118181818181818,0,0.0,6.422822796
Ds,110,234,344,2.1272727272727274,0,1.0,6.406001174
Ds,110,236,346,2.1454545454545455,0,1.0,6.369584101
Ds,110,238,348,2.1636363636363636,0,1.0,6.333528095
Ds,110,240,350,2.1818181818181817,0,1.0,6.297979949
Ds,110,242,352,2.2,0,1.0,6.263344588
Ds,110,244,354,2.2181818181818183,0,1.0,6.22872622
Ds,110,246,356,2.2363636363636363,0,1.0,6.194132567
Ds,110,248,358,2.2545454545454544,0,1.0,6.159796844
Ds,110,250,360,2.272727272727273,0,1.0,6.126191406
Ds,110,273,383,2.481818181818182,0,0.0,5.701637018
Ds,110,274,384,2.4909090909090907,0,1.0,5.689208234
Rg,111,158,269,1.4234234234234233,0,0.0,7.18173229
Rg,111,160,271,1.4414414414414414,0,0.0,7.187728376
Rg,111,161,272,1.4504504504504505,0,-1.0,7.188005382
Rg,111,162,273,1.4594594594594594,0,0.0,7.190540245
Rg,111,163,274,1.4684684684684686,0,-1.0,7.186771894
Rg,111,164,275,1.4774774774774775,0,0.0,7.185183782
Rg,111,165,276,1.4864864864864864,0,-1.0,7.180293319
Rg,111,166,277,1.4954954954954955,0,0.0,7.177527971
Rg,111,167,278,1.5045045045045045,0,-1.0,7.172387888
Rg,111,168,279,1.5135135135135136,0,0.0,7.169373857
Rg,111,169,280,1.5225225225225225,0,-1.0,7.163388039
Rg,111,170,281,1.5315315315315314,0,0.0,7.159649342
Rg,111,171,282,1.5405405405405406,0,-1.0,7.154232833
Rg,111,172,283,1.5495495495495495,0,0.0,7.151316537
Rg,111,173,284,1.5585585585585586,0,-1.0,7.145247056
Rg,111,174,285,1.5675675675675675,0,0.0,7.141946954
Rg,111,175,286,1.5765765765765767,0,-1.0,7.134161633
Rg,111,176,287,1.5855855855855856,0,0.0,7.129368861
Rg,111,177,288,1.5945945945945945,0,-1.0,7.122337097
Rg,111,178,289,1.6036036036036037,0,0.0,7.118634464
Rg,111,179,290,1.6126126126126126,0,-1.0,7.109994345
Rg,111,180,291,1.6216216216216217,0,0.0,7.104988859
Rg,111,181,292,1.6306306306306306,0,-1.0,7.095994719
Rg,111,182,293,1.6396396396396395,0,0.0,7.090783928
Rg,111,183,294,1.6486486486486487,0,-1.0,7.081131156
Rg,111,184,295,1.6576576576576576,0,0.0,7.075355685
Rg,111,185,296,1.6666666666666667,0,-1.0,7.060190209
Rg,111,186,297,1.6756756756756757,0,0.0,7.048930458
Rg,111,187,298,1.6846846846846846,0,-1.0,7.032448299
Rg,111,188,299,1.6936936936936937,0,0.0,7.019863562
Rg,111,189,300,1.7027027027027026,0,-1.0,7.006395417
Rg,111,190,301,1.7117117117117118,0,0.0,6.996292867
Rg,111,191,302,1.7207207207207207,0,-1.0,6.983456119
Rg,111,192,303,1.7297297297297298,0,0.0,6.973469967
Rg,111,193,304,1.7387387387387387,0,-1.0,6.96070402
Rg,111,194,305,1.7477477477477477,0,0.0,6.950707567
Rg,111,195,306,1.7567567567567568,0,-1.0,6.941836042
Rg,111,196,307,1.7657657657657657,0,0.0,6.935503371
Rg,111,197,308,1.7747747747747749,0,-1.0,6.927305864
Rg,111,198,309,1.7837837837837838,0,0.0,6.921405534
Rg,111,199,310,1.7927927927927927,0,-1.0,6.908602968
Rg,111,200,311,1.8018018018018018,0,0.0,6.898013785
Rg,111,201,312,1.8108108108108107,0,-1.0,6.884226375
Rg,111,202,313,1.8198198198198199,0,0.0,6.872639058
Rg,111,203,314,1.8288288288288288,0,-1.0,6.857722299
Rg,111,204,315,1.837837837837838,0,0.0,6.845146787
Rg,111,205,316,1.8468468468468469,0,-1.0,6.832315136
Rg,111,206,317,1.8558558558558558,0,0.0,6.821933946
Rg,111,207,318,1.864864864864865,0,-1.0,6.808769642
Rg,111,208,319,1.8738738738738738,0,0.0,6.79802152
Rg,111,209,320,1.882882882882883,0,-1.0,6.784249575
Rg,111,210,321,1.8918918918918919,0,0.0,6.772859757
Rg,111,211,322,1.9009009009009008,0,-1.0,6.758595196
Rg,111,212,323,1.90990990990991,0,0.0,6.746663981
Rg,111,213,324,1.9189189189189189,0,-1.0,6.732315346
Rg,111,214,325,1.927927927927928,0,0.0,6.720239471
Rg,111,215,326,1.936936936936937,0,-1.0,6.706045926
Rg,111,216,327,1.945945945945946,0,0.0,6.694062373
Rg,111,217,328,1.954954954954955,0,-1.0,6.67997129
Rg,111,218,329,1.9639639639639639,0,0.0,6.668030274
Rg,111,219,330,1.972972972972973,0,-1.0,6.653256645
Rg,111,220,331,1.981981981981982,0,0.0,6.640573511
Rg,111,221,332,1.990990990990991,0,-1.0,6.624591377
Rg,111,222,333,2.0,0,0.0,6.610620429
Rg,111,223,334,2.009009009009009,0,-1.0,6.59421085
Rg,111,224,335,2.018018018018018,0,0.0,6.579700907
Rg,111,225,336,2.027027027027027,0,-1.0,6.563525027
Rg,111,226,337,2.036036036036036,0,0.0,6.549136226
Rg,111,227,338,2.045045045045045,0,-1.0,6.533210275
Rg,111,228,339,2.054054054054054,0,0.0,6.518992622
Rg,111,229,340,2.063063063063063,0,-1.0,6.503164306
Rg,111,230,341,2.0720720720720722,0,0.0,6.489003636
Rg,111,231,342,2.081081081081081,0,-1.0,6.472467772
Rg,111,232,343,2.09009009009009,0,0.0,6.457589816
Rg,111,233,344,2.099099099099099,0,-1.0,6.439666081
Rg,111,234,345,2.108108108108108,0,0.0,6.423418803
Rg,111,235,346,2.1171171171171173,0,-1.0,6.40488265
Rg,111,236,347,2.126126126126126,0,0.0,6.388070282
Rg,111,238,349,2.144144144144144,0,0.0,6.352995209
Rg,111,240,351,2.1621621621621623,0,0.0,6.318324758
Rg,111,241,352,2.171171171171171,0,-1.0,6.300378994
Rg,111,242,353,2.18018018018018,0,0.0,6.284434756
Rg,111,244,355,2.1981981981981984,0,0.0,6.250540769
Rg,111,246,357,2.2162162162162162,0,0.0,6.216531896
Rg,111,248,359,2.234234234234234,0,0.0,6.182499955
Rg,111,250,361,2.2522522522522523,0,0.0,6.149464075
Rg,111,252,363,2.27027027027027,0,0.0,6.116051
Rg,111,273,384,2.4594594594594597,0,-1.0,5.729841698
Rg,111,274,385,2.4684684684684686,0,0.0,5.718077501
Cn,112,158,270,1.4107142857142858,0,1.0,7.157192585
Cn,112,159,271,1.4196428571428572,0,0.0,7.159821749
Cn,112,160,272,1.4285714285714286,0,1.0,7.164977504
Cn,112,161,273,1.4375,0,0.0,7.166134773
Cn,112,162,274,1.4464285714285714,0,1.0,7.169675182
Cn,112,163,275,1.4553571428571428,0,0.0,7.166847855
Cn,112,164,276,1.4642857142857142,0,1.0,7.166305239
Cn,112,165,277,1.4732142857142858,0,0.0,7.162498892
Cn,112,166,278,1.4821428571428572,0,1.0,7.160894665
Cn,112,167,279,1.4910714285714286,0,0.0,7.15676809
Cn,112,168,280,1.5,0,1.0,7.154811768
Cn,112,169,281,1.5089285714285714,0,0.0,7.14968269
Cn,112,170,282,1.5178571428571428,0,1.0,7.146819028
Cn,112,171,283,1.5267857142857142,0,0.0,7.14262071
Cn,112,172,284,1.5357142857142858,0,1.0,7.140839711
Cn,112,173,285,1.5446428571428572,0,0.0,7.135602281
Cn,112,174,286,1.5535714285714286,0,1.0,7.132946531
Cn,112,175,287,1.5625,0,0.0,7.12579169
Cn,112,176,288,1.5714285714285714,0,1.0,7.121437705
Cn,112,177,289,1.5803571428571428,0,0.0,7.114918125
Cn,112,178,290,1.5892857142857142,0,1.0,7.111577728
Cn,112,179,291,1.5982142857142858,0,0.0,7.103570344
Cn,112,180,292,1.6071428571428572,0,1.0,7.099062442
Cn,112,181,293,1.6160714285714286,0,0.0,7.090881188
Cn,112,182,294,1.625,0,1.0,7.086305793
Cn,112,183,295,1.6339285714285714,0,0.0,7.077397512
Cn,112,184,296,1.6428571428571428,0,1.0,7.072170351
Cn,112,185,297,1.6517857142857142,0,0.0,7.057869118
Cn,112,186,298,1.6607142857142858,0,1.0,7.047289383
Cn,112,187,299,1.6696428571428572,0,0.0,7.031725334
Cn,112,188,300,1.6785714285714286,0,1.0,7.019881433
Cn,112,189,301,1.6875,0,0.0,7.006366927
Cn,112,190,302,1.6964285714285714,0,1.0,6.996153533
Cn,112,191,303,1.7053571428571428,0,0.0,6.983821584
Cn,112,192,304,1.7142857142857142,0,1.0,6.974380069
Cn,112,193,305,1.7232142857142858,0,0.0,6.96230542
Cn,112,194,306,1.7321428571428572,0,1.0,6.952982788
Cn,112,195,307,1.7410714285714286,0,0.0,6.94067844
Cn,112,196,308,1.75,0,1.0,6.931005198
Cn,112,197,309,1.7589285714285714,0,0.0,6.926894104
Cn,112,198,310,1.7678571428571428,0,1.0,6.925192516
Cn,112,199,311,1.7767857142857142,0,0.0,6.912849669
Cn,112,200,312,1.7857142857142858,0,1.0,6.902784439
Cn,112,201,313,1.7946428571428572,0,0.0,6.889505824
Cn,112,202,314,1.8035714285714286,0,1.0,6.878493064
Cn,112,203,315,1.8125,0,0.0,6.863866051
Cn,112,204,316,1.8214285714285714,0,1.0,6.851606943
Cn,112,205,317,1.8303571428571428,0,0.0,6.839067155
Cn,112,206,318,1.8392857142857142,0,1.0,6.828981075
Cn,112,207,319,1.8482142857142858,0,0.0,6.816097448
Cn,112,208,320,1.8571428571428572,0,1.0,6.805660553
Cn,112,209,321,1.8660714285714286,0,0.0,6.792248897
Cn,112,210,322,1.875,0,1.0,6.781267146
Cn,112,211,323,1.8839285714285714,0,0.0,6.767373427
Cn,112,212,324,1.8928571428571428,0,1.0,6.755871361
Cn,112,213,325,1.9017857142857142,0,0.0,6.741865022
Cn,112,214,326,1.9107142857142858,0,1.0,6.73019554
Cn,112,215,327,1.9196428571428572,0,0.0,6.716317413
Cn,112,216,328,1.9285714285714286,0,1.0,6.704719405
Cn,112,217,329,1.9375,0,0.0,6.690922657
Cn,112,218,330,1.9464285714285714,0,1.0,6.679356245
Cn,112,219,331,1.9553571428571428,0,0.0,6.664919187
Cn,112,220,332,1.9642857142857142,0,1.0,6.652662117
Cn,112,221,333,1.9732142857142858,0,0.0,6.63713294
Cn,112,222,334,1.9821428571428572,0,1.0,6.623701695
Cn,112,223,335,1.9910714285714286,0,0.0,6.60788046
Cn,112,224,336,2.0,0,1.0,6.594023857
Cn,112,225,337,2.0089285714285716,0,0.0,6.578429424
Cn,112,226,338,2.017857142857143,0,1.0,6.564658988
Cn,112,227,339,2.0267857142857144,0,0.0,6.54926759
Cn,112,228,340,2.0357142857142856,0,1.0,6.535600956
Cn,112,229,341,2.044642857142857,0,0.0,6.520223475
Cn,112,230,342,2.0535714285714284,0,1.0,6.506520181
Cn,112,231,343,2.0625,0,0.0,6.49044049
Cn,112,232,344,2.0714285714285716,0,1.0,6.476018424
Cn,112,233,345,2.080357142857143,0,0.0,6.458656861
Cn,112,234,346,2.0892857142857144,0,1.0,6.442954514
Cn,112,235,347,2.0982142857142856,0,0.0,6.425025216
Cn,112,236,348,2.107142857142857,0,1.0,6.408769534
Cn,112,237,349,2.1160714285714284,0,0.0,6.390909768
Cn,112,238,350,2.125,0,1.0,6.374758603
Cn,112,239,351,2.1339285714285716,0,0.0,6.356991259
Cn,112,240,352,2.142857142857143,0,1.0,6.340989114
Cn,112,241,353,2.1517857142857144,0,0.0,6.323443977
Cn,112,242,354,2.1607142857142856,0,1.0,6.307743373
Cn,112,243,355,2.169642857142857,0,0.0,6.290101307
Cn,112,244,356,2.1785714285714284,0,1.0,6.274406242
Cn,112,246,358,2.1964285714285716,0,1.0,6.240866394
Cn,112,248,360,2.2142857142857144,0,1.0,6.206998256
Cn,112,250,362,2.232142857142857,0,1.0,6.174447801
Cn,112,252,364,2.25,0,1.0,6.141491253
Cn,112,254,366,2.267857142857143,0,1.0,6.10797682
Cn,112,256,368,2.2857142857142856,0,1.0,6.075099902
Cn,112,273,385,2.4375,0,0.0,5.760859255
Cn,112,274,386,2.4464285714285716,0,1.0,5.749677132
Nh,113,160,273,1.415929203539823,0,0.0,7.137409136
Nh,113,162,275,1.4336283185840708,0,0.0,7.144046513
Nh,113,163,276,1.4424778761061947,0,-1.0,7.142367402
Nh,113,164,277,1.4513274336283186,0,0.0,7.142910935
Nh,113,165,278,1.4601769911504425,0,-1.0,7.140095227
Nh,113,166,279,1.4690265486725664,0,0.0,7.139403588
Nh,113,167,280,1.4778761061946903,0,-1.0,7.136256782
Nh,113,168,281,1.4867256637168142,0,0.0,7.135189164
Nh,113,169,282,1.4955752212389382,0,-1.0,7.131096418
Nh,113,170,283,1.5044247787610618,0,0.0,7.129146428
Nh,113,171,284,1.5132743362831858,0,-1.0,7.125885162
Nh,113,172,285,1.5221238938053097,0,0.0,7.124875474
Nh,113,173,286,1.5309734513274336,0,-1.0,7.120562647
Nh,113,174,287,1.5398230088495575,0,0.0,7.118633401
Nh,113,175,288,1.5486725663716814,0,-1.0,7.112257403
Nh,113,176,289,1.5575221238938053,0,0.0,7.108483159
Nh,113,177,290,1.5663716814159292,0,-1.0,7.102687562
Nh,113,178,291,1.575221238938053,0,0.0,7.099889814
Nh,113,179,292,1.584070796460177,0,-1.0,7.092759551
Nh,113,180,293,1.592920353982301,0,0.0,7.08894413
Nh,113,181,294,1.6017699115044248,0,-1.0,7.081582517
Nh,113,182,295,1.6106194690265487,0,0.0,7.077615119
Nh,113,183,296,1.6194690265486726,0,-1.0,7.069089301
Nh,113,184,297,1.6283185840707965,0,0.0,7.064025101
Nh,113,185,298,1.6371681415929205,0,-1.0,7.050285352
Nh,113,186,299,1.6460176991150441,0,0.0,7.040058084
Nh,113,187,300,1.654867256637168,0,-1.0,7.025001913
Nh,113,188,301,1.663716814159292,0,0.0,7.013455359
Nh,113,189,302,1.6725663716814159,0,-1.0,7.000077699
Nh,113,190,303,1.6814159292035398,0,0.0,6.989933974
Nh,113,191,304,1.6902654867256637,0,-1.0,6.978441803
Nh,113,192,305,1.6991150442477876,0,0.0,6.969759085
Nh,113,193,306,1.7079646017699115,0,-1.0,6.958590108
Nh,113,194,307,1.7168141592920354,0,0.0,6.950004974
Nh,113,195,308,1.7256637168141593,0,-1.0,6.938267948
Nh,113,196,309,1.7345132743362832,0,0.0,6.929058146
Nh,113,197,310,1.7433628318584071,0,-1.0,6.924386335
Nh,113,198,311,1.752212389380531,0,0.0,6.922113968
Nh,113,199,312,1.761061946902655,0,-1.0,6.910111878
Nh,113,200,313,1.7699115044247788,0,0.0,6.900474537
Nh,113,201,314,1.7787610619469028,0,-1.0,6.887670682
Nh,113,202,315,1.7876106194690264,0,0.0,6.877231787
Nh,113,203,316,1.7964601769911503,0,-1.0,6.863394449
Nh,113,204,317,1.8053097345132743,0,0.0,6.851973107
Nh,113,205,318,1.8141592920353982,0,-1.0,6.839801129
Nh,113,206,319,1.823008849557522,0,0.0,6.830082379
Nh,113,207,320,1.831858407079646,0,-1.0,6.817545991
Nh,113,208,321,1.8407079646017699,0,0.0,6.807466106
Nh,113,209,322,1.8495575221238938,0,-1.0,6.794475323
Nh,113,210,323,1.8584070796460177,0,0.0,6.783946978
Nh,113,211,324,1.8672566371681416,0,-1.0,6.770455901
Nh,113,212,325,1.8761061946902655,0,0.0,6.759409397
Nh,113,213,326,1.8849557522123894,0,-1.0,6.745794135
Nh,113,214,327,1.8938053097345133,0,0.0,6.734589052
Nh,113,215,328,1.9026548672566372,0,-1.0,6.721110466
Nh,113,216,329,1.9115044247787611,0,0.0,6.710006003
Nh,113,217,330,1.920353982300885,0,-1.0,6.696607876
Nh,113,218,331,1.9292035398230087,0,0.0,6.685550689
Nh,113,219,332,1.9380530973451326,0,-1.0,6.671494301
Nh,113,220,333,1.9469026548672566,0,0.0,6.659740429
Nh,113,221,334,1.9557522123893805,0,-1.0,6.644666874
Nh,113,222,335,1.9646017699115044,0,0.0,6.631813988
Nh,113,223,336,1.9734513274336283,0,-1.0,6.616531539
Nh,113,224,337,1.9823008849557522,0,0.0,6.603316564
Nh,113,225,338,1.991150442477876,0,-1.0,6.588338882
Nh,113,226,339,2.0,0,0.0,6.575252463
Nh,113,227,340,2.0088495575221237,0,-1.0,6.560493868
Nh,113,228,341,2.017699115044248,0,0.0,6.54748751
Nh,113,229,342,2.0265486725663715,0,-1.0,6.532685503
Nh,113,230,343,2.0353982300884956,0,0.0,6.519542493
Nh,113,231,344,2.0442477876106193,0,-1.0,6.504032238
Nh,113,232,345,2.0530973451327434,0,0.0,6.490127583
Nh,113,233,346,2.061946902654867,0,-1.0,6.473393436
Nh,113,234,347,2.0707964601769913,0,0.0,6.458240409
Nh,113,235,348,2.079646017699115,0,-1.0,6.440876733
Nh,113,236,349,2.088495575221239,0,0.0,6.425086908
Nh,113,237,350,2.0973451327433628,0,-1.0,6.407708849
Nh,113,238,351,2.106194690265487,0,0.0,6.391919581
Nh,113,239,352,2.1150442477876106,0,-1.0,6.374594798
Nh,113,240,353,2.1238938053097347,0,0.0,6.358899354
Nh,113,241,354,2.1327433628318584,0,-1.0,6.34179337
Nh,113,242,355,2.1415929203539825,0,0.0,6.326389893
Nh,113,243,356,2.150442477876106,0,-1.0,6.30919861
Nh,113,244,357,2.15929203539823,0,0.0,6.293811098
Nh,113,245,358,2.168141592920354,0,-1.0,6.276396813
Nh,113,246,359,2.1769911504424777,0,0.0,6.260906783
Nh,113,248,361,2.1946902654867255,0,0.0,6.227705687
Nh,113,249,362,2.2035398230088497,0,-1.0,6.210537445
Nh,113,250,363,2.2123893805309733,0,0.0,6.195769923
Nh,113,252,365,2.230088495575221,0,0.0,6.163353786
Nh,113,254,367,2.247787610619469,0,0.0,6.130409984
Nh,113,256,369,2.265486725663717,0,0.0,6.098086306
Nh,113,273,386,2.415929203539823,0,-1.0,5.786791938
Nh,113,274,387,2.424778761061947,0,0.0,5.775718171
Fl,114,160,274,1.4035087719298245,0,1.0,7.11315577
Fl,114,161,275,1.412280701754386,0,0.0,7.116167091
Fl,114,162,276,1.4210526315789473,0,1.0,7.121460591
Fl,114,163,277,1.4298245614035088,0,0.0,7.120763357
Fl,114,164,278,1.4385964912280702,0,1.0,7.122228338
Fl,114,165,279,1.4473684210526316,0,0.0,7.120495183
Fl,114,166,280,1.456140350877193,0,1.0,7.12080795
Fl,114,167,281,1.4649122807017543,0,0.0,7.118661235
Fl,114,168,282,1.4736842105263157,0,1.0,7.118503131
Fl,114,169,283,1.4824561403508771,0,0.0,7.115494385
Fl,114,170,284,1.4912280701754386,0,1.0,7.114506264
Fl,114,171,285,1.5,0,0.0,7.112111505
Fl,114,172,286,1.5087719298245614,0,1.0,7.111804231
Fl,114,173,287,1.5175438596491229,0,0.0,7.108311812
Fl,114,174,288,1.5263157894736843,0,1.0,7.107006983
Fl,114,175,289,1.5350877192982457,0,0.0,7.101326204
Fl,114,176,290,1.543859649122807,0,1.0,7.098050024
Fl,114,177,291,1.5526315789473684,0,0.0,7.092963801
Fl,114,178,292,1.5614035087719298,0,1.0,7.090695432
Fl,114,179,293,1.5701754385964912,0,0.0,7.084240372
Fl,114,180,294,1.5789473684210527,0,1.0,7.080918143
Fl,114,181,295,1.587719298245614,0,0.0,7.074298624
Fl,114,182,296,1.5964912280701755,0,1.0,7.070863628
Fl,114,183,297,1.605263157894737,0,0.0,7.063111737
Fl,114,184,298,1.6140350877192982,0,1.0,7.058600799
Fl,114,185,299,1.6228070175438596,0,0.0,7.045748
Fl,114,186,300,1.631578947368421,0,1.0,7.03619788
Fl,114,187,301,1.6403508771929824,0,0.0,7.022112143
Fl,114,188,302,1.6491228070175439,0,1.0,7.011323818
Fl,114,189,303,1.6578947368421053,0,0.0,6.997966485
Fl,114,190,304,1.6666666666666667,0,1.0,6.987777118
Fl,114,191,305,1.6754385964912282,0,0.0,6.976974302
Fl,114,192,306,1.6842105263157894,0,1.0,6.968901477
Fl,114,193,307,1.6929824561403508,0,0.0,6.958527919
Fl,114,194,308,1.7017543859649122,0,1.0,6.950571838
Fl,114,195,309,1.7105263157894737,0,0.0,6.939524961
Fl,114,196,310,1.719298245614035,0,1.0,6.930901303
Fl,114,197,311,1.7280701754385965,0,0.0,6.925410412
Fl,114,198,312,1.736842105263158,0,1.0,6.922310625
Fl,114,199,313,1.7456140350877194,0,0.0,6.910653045
Fl,114,200,314,1.7543859649122806,0,1.0,6.901446777
Fl,114,201,315,1.763157894736842,0,0.0,6.889130733
Fl,114,202,316,1.7719298245614035,0,1.0,6.879278047
Fl,114,203,317,1.780701754385965,0,0.0,6.866268795
Fl,114,204,318,1.7894736842105263,0,1.0,6.855723075
Fl,114,205,319,1.7982456140350878,0,0.0,6.843848116
Fl,114,206,320,1.8070175438596492,0,1.0,6.83442635
Fl,114,207,321,1.8157894736842106,0,0.0,6.822173576
Fl,114,208,322,1.8245614035087718,0,1.0,6.812387422
Fl,114,209,323,1.8333333333333333,0,0.0,6.799786672
Fl,114,210,324,1.8421052631578947,0,1.0,6.789680892
Fl,114,211,325,1.8508771929824561,0,0.0,6.776591815
Fl,114,212,326,1.8596491228070176,0,1.0,6.765999908
Fl,114,213,327,1.868421052631579,0,0.0,6.752765067
Fl,114,214,328,1.8771929824561404,0,1.0,6.742013338
Fl,114,215,329,1.8859649122807018,0,0.0,6.728871751
Fl,114,216,330,1.894736842105263,0,1.0,6.718198097
Fl,114,217,331,1.9035087719298245,0,0.0,6.705100668
Fl,114,218,332,1.912280701754386,0,1.0,6.694454702
Fl,114,219,333,1.9210526315789473,0,0.0,6.680718411
Fl,114,220,334,1.9298245614035088,0,1.0,6.669406787
Fl,114,221,335,1.9385964912280702,0,0.0,6.654746531
Fl,114,222,336,1.9473684210526316,0,1.0,6.642429199
Fl,114,223,337,1.956140350877193,0,0.0,6.627717828
Fl,114,224,338,1.9649122807017543,0,1.0,6.615175973
Fl,114,225,339,1.9736842105263157,0,0.0,6.600806847
Fl,114,226,340,1.9824561403508771,0,1.0,6.5883959
Fl,114,227,341,1.9912280701754386,0,0.0,6.574198868
Fl,114,228,342,2.0,0,1.0,6.561781807
Fl,114,229,343,2.008771929824561,0,0.0,6.547467058
Fl,114,230,344,2.017543859649123,0,1.0,6.534796715
Fl,114,231,345,2.026315789473684,0,0.0,6.519803472
Fl,114,232,346,2.0350877192982457,0,1.0,6.506364402
Fl,114,233,347,2.043859649122807,0,0.0,6.490220787
Fl,114,234,348,2.0526315789473686,0,1.0,6.475580848
Fl,114,235,349,2.06140350877193,0,0.0,6.458811387
Fl,114,236,350,2.0701754385964914,0,1.0,6.44351642
Fl,114,237,351,2.0789473684210527,0,0.0,6.426663288
Fl,114,238,352,2.087719298245614,0,1.0,6.411279568
Fl,114,239,353,2.0964912280701755,0,0.0,6.394418462
Fl,114,240,354,2.1052631578947367,0,1.0,6.37905148
Fl,114,241,355,2.1140350877192984,0,0.0,6.362351524
Fl,114,242,356,2.1228070175438596,0,1.0,6.347213028
Fl,114,243,357,2.1315789473684212,0,0.0,6.33039519
Fl,114,244,358,2.1403508771929824,0,1.0,6.31523912
Fl,114,245,359,2.1491228070175437,0,0.0,6.298159259
Fl,114,246,360,2.1578947368421053,0,1.0,6.282866153
Fl,114,247,361,2.1666666666666665,0,0.0,6.265483975
Fl,114,248,362,2.175438596491228,0,1.0,6.250211378
Fl,114,249,363,2.1842105263157894,0,0.0,6.233332399
Fl,114,250,364,2.192982456140351,0,1.0,6.218808234
Fl,114,252,366,2.210526315789474,0,1.0,6.186823041
Fl,114,254,368,2.2280701754385963,0,1.0,6.154345476
Fl,114,256,370,2.245614035087719,0,1.0,6.122545035
Fl,114,258,372,2.263157894736842,0,1.0,6.090065
Fl,114,273,387,2.3947368421052633,0,0.0,5.815484537
Fl,114,274,388,2.4035087719298245,0,1.0,5.804422861
Mc,115,162,277,1.4086956521739131,0,0.0,7.093495134
Mc,115,164,279,1.4260869565217391,0,0.0,7.096530799
Mc,115,165,280,1.434782608695652,0,-1.0,7.095746411
Mc,115,166,281,1.4434782608695653,0,0.0,7.096977391
Mc,115,167,282,1.4521739130434783,0,-1.0,7.09574677
Mc,115,168,283,1.4608695652173913,0,0.0,7.096427117
Mc,115,169,284,1.4695652173913043,0,-1.0,7.094395585
Mc,115,170,285,1.4782608695652173,0,0.0,7.094237751
Mc,115,171,286,1.4869565217391305,0,-1.0,7.092742874
Mc,115,172,287,1.4956521739130435,0,0.0,7.093133916
Mc,115,173,288,1.5043478260869565,0,-1.0,7.090579351
Mc,115,174,289,1.5130434782608695,0,0.0,7.089997239
Mc,115,175,290,1.5217391304347827,0,-1.0,7.085192624
Mc,115,176,291,1.5304347826086957,0,0.0,7.08258934
Mc,115,177,292,1.5391304347826087,0,-1.0,7.078447089
Mc,115,178,293,1.5478260869565217,0,0.0,7.076913536
Mc,115,179,294,1.5565217391304347,0,-1.0,7.071279466
Mc,115,180,295,1.565217391304348,0,0.0,7.068548078
Mc,115,181,296,1.5739130434782609,0,-1.0,7.06261672
Mc,115,182,297,1.5826086956521739,0,0.0,7.059626909
Mc,115,183,298,1.5913043478260869,0,-1.0,7.052313832
Mc,115,184,299,1.6,0,0.0,7.047996783
Mc,115,185,300,1.608695652173913,0,-1.0,7.035729
Mc,115,186,301,1.617391304347826,0,0.0,7.026528817
Mc,115,187,302,1.626086956521739,0,-1.0,7.012960172
Mc,115,188,303,1.6347826086956523,0,0.0,7.002456475
Mc,115,189,304,1.6434782608695653,0,-1.0,6.989687326
Mc,115,190,305,1.6521739130434783,0,0.0,6.979892174
Mc,115,191,306,1.6608695652173913,0,-1.0,6.969241647
Mc,115,192,307,1.6695652173913043,0,0.0,6.961259511
Mc,115,193,308,1.6782608695652175,0,-1.0,6.953886347
Mc,115,194,309,1.6869565217391305,0,0.0,6.948973068
Mc,115,195,310,1.6956521739130435,0,-1.0,6.936742332
Mc,115,196,311,1.7043478260869565,0,0.0,6.926916553
Mc,115,197,312,1.7130434782608697,0,-1.0,6.918949173
Mc,115,198,313,1.7217391304347827,0,0.0,6.913241406
Mc,115,199,314,1.7304347826086957,0,-1.0,6.903754315
Mc,115,200,315,1.7391304347826086,0,0.0,6.89669119
Mc,115,201,316,1.7478260869565216,0,-1.0,6.884820547
Mc,115,202,317,1.7565217391304349,0,0.0,6.875547473
Mc,115,203,318,1.7652173913043478,0,-1.0,6.863138827
Mc,115,204,319,1.7739130434782608,0,0.0,6.853289558
Mc,115,205,320,1.7826086956521738,0,-1.0,6.841859409
Mc,115,206,321,1.791304347826087,0,0.0,6.83292334
Mc,115,207,322,1.8,0,-1.0,6.821086615
Mc,115,208,323,1.808695652173913,0,0.0,6.811759173
Mc,115,209,324,1.817391304347826,0,-1.0,6.799623423
Mc,115,210,325,1.826086956521739,0,0.0,6.790033477
Mc,115,211,326,1.8347826086956522,0,-1.0,6.777403
Mc,115,212,327,1.8434782608695652,0,0.0,6.767321425
Mc,115,213,328,1.8521739130434782,0,-1.0,6.754553415
Mc,115,214,329,1.8608695652173912,0,0.0,6.744314182
Mc,115,215,330,1.8695652173913044,0,-1.0,6.731649242
Mc,115,216,331,1.8782608695652174,0,0.0,6.721492308
Mc,115,217,332,1.8869565217391304,0,-1.0,6.708859867
Mc,115,218,333,1.8956521739130434,0,0.0,6.698716402
Mc,115,219,334,1.9043478260869566,0,-1.0,6.685412725
Mc,115,220,335,1.9130434782608696,0,0.0,6.674574645
Mc,115,221,336,1.9217391304347826,0,-1.0,6.660339485
Mc,115,222,337,1.9304347826086956,0,0.0,6.648497754
Mc,115,223,338,1.9391304347826086,0,-1.0,6.634211565
Mc,115,224,339,1.9478260869565218,0,0.0,6.622156047
Mc,115,225,340,1.9565217391304348,0,-1.0,6.608264818
Mc,115,226,341,1.9652173913043478,0,0.0,6.596396158
Mc,115,227,342,1.9739130434782608,0,-1.0,6.582719743
Mc,115,228,343,1.982608695652174,0,0.0,6.570885609
Mc,115,229,344,1.991304347826087,0,-1.0,6.55708386
Mc,115,230,345,2.0,0,0.0,6.544990841
Mc,115,231,346,2.008695652173913,0,-1.0,6.53050813
Mc,115,232,347,2.017391304347826,0,0.0,6.517641798
Mc,115,233,348,2.026086956521739,0,-1.0,6.502054348
Mc,115,234,349,2.034782608695652,0,0.0,6.488017281
Mc,115,235,350,2.0434782608695654,0,-1.0,6.471760814
Mc,115,236,351,2.0521739130434784,0,0.0,6.456996604
Mc,115,237,352,2.0608695652173914,0,-1.0,6.440577401
Mc,115,238,353,2.0695652173913044,0,0.0,6.425601272
Mc,115,239,354,2.0782608695652174,0,-1.0,6.409134189
Mc,115,240,355,2.0869565217391304,0,0.0,6.394082011
Mc,115,241,356,2.0956521739130434,0,-1.0,6.377825722
Mc,115,242,357,2.1043478260869564,0,0.0,6.363013387
Mc,115,243,358,2.1130434782608694,0,-1.0,6.346683626
Mc,115,244,359,2.121739130434783,0,0.0,6.331889072
Mc,115,245,360,2.130434782608696,0,-1.0,6.315290031
Mc,115,246,361,2.139130434782609,0,0.0,6.300456992
Mc,115,247,362,2.1478260869565218,0,-1.0,6.283658204
Mc,115,248,363,2.1565217391304348,0,0.0,6.268925405
Mc,115,249,364,2.1652173913043478,0,-1.0,6.252415025
Mc,115,250,365,2.1739130434782608,0,0.0,6.238093216
Mc,115,251,366,2.1826086956521737,0,-1.0,6.221260153
Mc,115,252,367,2.1913043478260867,0,0.0,6.20662742
Mc,115,254,369,2.208695652173913,0,0.0,6.174663523
Mc,115,256,371,2.226086956521739,0,0.0,6.143354472
Mc,115,258,373,2.243478260869565,0,0.0,6.111049367
Mc,115,273,388,2.373913043478261,0,-1.0,5.83927926
Mc,115,274,389,2.382608695652174,0,0.0,5.828367306
Lv,116,163,279,1.4051724137931034,0,0.0,7.069999706
Lv,116,164,280,1.4137931034482758,0,1.0,7.073558471
Lv,116,165,281,1.4224137931034482,0,0.0,7.073804673
Lv,116,166,282,1.4310344827586208,0,1.0,7.076035333
Lv,116,167,283,1.4396551724137931,0,0.0,7.07575141
Lv,116,168,284,1.4482758620689655,0,1.0,7.077301137
Lv,116,169,285,1.456896551724138,0,0.0,7.076288551
Lv,116,170,286,1.4655172413793103,0,1.0,7.077003472
Lv,116,171,287,1.4741379310344827,0,0.0,7.076300631
Lv,116,172,288,1.4827586206896552,0,1.0,7.077284295
Lv,116,173,289,1.4913793103448276,0,0.0,7.075569062
Lv,116,174,290,1.5,0,1.0,7.075613317
Lv,116,175,291,1.5086206896551724,0,0.0,7.071607694
Lv,116,176,292,1.5172413793103448,0,1.0,7.069602058
Lv,116,177,293,1.5258620689655173,0,0.0,7.066393072
Lv,116,178,294,1.5344827586206897,0,1.0,7.065585116
Lv,116,179,295,1.543103448275862,0,0.0,7.060599458
Lv,116,180,296,1.5517241379310345,0,1.0,7.058289047
Lv,116,181,297,1.5603448275862069,0,0.0,7.052963465
Lv,116,182,298,1.5689655172413792,0,1.0,7.050338631
Lv,116,183,299,1.5775862068965518,0,0.0,7.043857087
Lv,116,184,300,1.5862068965517242,0,1.0,7.04012566
Lv,116,185,301,1.5948275862068966,0,0.0,7.028769724
Lv,116,186,302,1.603448275862069,0,1.0,7.020245699
Lv,116,187,303,1.6120689655172413,0,0.0,7.007654287
Lv,116,188,304,1.6206896551724137,0,1.0,6.997893862
Lv,116,189,305,1.6293103448275863,0,0.0,6.98573021
Lv,116,190,306,1.6379310344827587,0,1.0,6.976347732
Lv,116,191,307,1.646551724137931,0,0.0,6.965633485
Lv,116,192,308,1.6551724137931034,0,1.0,6.957527838
Lv,116,193,309,1.6637931034482758,0,0.0,6.952890586
Lv,116,194,310,1.6724137931034482,0,1.0,6.950757055
Lv,116,195,311,1.6810344827586208,0,0.0,6.937428588
Lv,116,196,312,1.6896551724137931,0,1.0,6.926486391
Lv,116,197,313,1.6982758620689655,0,0.0,6.916003789
Lv,116,198,314,1.706896551724138,0,1.0,6.907650401
Lv,116,199,315,1.7155172413793103,0,0.0,6.900226619
Lv,116,200,316,1.7241379310344827,0,1.0,6.895200297
Lv,116,201,317,1.7327586206896552,0,0.0,6.883784801
Lv,116,202,318,1.7413793103448276,0,1.0,6.875100179
Lv,116,203,319,1.75,0,0.0,6.863323549
Lv,116,204,320,1.7586206896551724,0,1.0,6.854201341
Lv,116,205,321,1.7672413793103448,0,0.0,6.843167816
Lv,116,206,322,1.7758620689655173,0,1.0,6.834669304
Lv,116,207,323,1.7844827586206897,0,0.0,6.823184619
Lv,116,208,324,1.793103448275862,0,1.0,6.814252012
Lv,116,209,325,1.8017241379310345,0,0.0,6.802553369
Lv,116,210,326,1.8103448275862069,0,1.0,6.793451224
Lv,116,211,327,1.8189655172413792,0,0.0,6.78127985
Lv,116,212,328,1.8275862068965518,0,1.0,6.77170879
Lv,116,213,329,1.8362068965517242,0,0.0,6.759398626
Lv,116,214,330,1.8448275862068966,0,1.0,6.749662682
Lv,116,215,331,1.853448275862069,0,0.0,6.737410683
Lv,116,216,332,1.8620689655172413,0,1.0,6.727706892
Lv,116,217,333,1.8706896551724137,0,0.0,6.715441444
Lv,116,218,334,1.8793103448275863,0,1.0,6.705702844
Lv,116,219,335,1.8879310344827587,0,0.0,6.69277457
Lv,116,220,336,1.896551724137931,0,1.0,6.682352935
Lv,116,221,337,1.9051724137931034,0,0.0,6.668510751
Lv,116,222,338,1.9137931034482758,0,1.0,6.657112396
Lv,116,223,339,1.9224137931034482,0,0.0,6.643280558
Lv,116,224,340,1.9310344827586208,0,1.0,6.631740012
Lv,116,225,341,1.9396551724137931,0,0.0,6.61831522
Lv,116,226,342,1.9482758620689655,0,1.0,6.606977076
Lv,116,227,343,1.956896551724138,0,0.0,6.593743035
Lv,116,228,344,1.9655172413793103,0,1.0,6.582413674
Lv,116,229,345,1.9741379310344827,0,0.0,6.569031942
Lv,116,230,346,1.9827586206896552,0,1.0,6.557423419
Lv,116,231,347,1.9913793103448276,0,0.0,6.543382752
Lv,116,232,348,2.0,0,1.0,6.531020704
Lv,116,233,349,2.0086206896551726,0,0.0,6.515945135
Lv,116,234,350,2.0172413793103448,0,1.0,6.502466646
Lv,116,235,351,2.0258620689655173,0,0.0,6.486736
Lv,116,236,352,2.0344827586206895,0,1.0,6.472515207
Lv,116,237,353,2.043103448275862,0,0.0,6.456570918
Lv,116,238,354,2.0517241379310347,0,1.0,6.442043285
Lv,116,239,355,2.060344827586207,0,0.0,6.426001839
Lv,116,240,356,2.0689655172413794,0,1.0,6.411296357
Lv,116,241,357,2.0775862068965516,0,0.0,6.395464515
Lv,116,242,358,2.086206896551724,0,1.0,6.380959888
Lv,116,243,359,2.0948275862068964,0,0.0,6.365043351
Lv,116,244,360,2.103448275862069,0,1.0,6.350536572
Lv,116,245,361,2.1120689655172415,0,0.0,6.334391033
Lv,116,246,362,2.1206896551724137,0,1.0,6.319991011
Lv,116,247,363,2.1293103448275863,0,0.0,6.303699298
Lv,116,248,364,2.1379310344827585,0,1.0,6.289430637
Lv,116,249,365,2.146551724137931,0,0.0,6.273256416
Lv,116,250,366,2.1551724137931036,0,1.0,6.259105617
Lv,116,251,367,2.163793103448276,0,0.0,6.242558965
Lv,116,252,368,2.1724137931034484,0,1.0,6.22804784
Lv,116,253,369,2.1810344827586206,0,0.0,6.211258076
Lv,116,254,370,2.189655172413793,0,1.0,6.196519189
Lv,116,255,371,2.1982758620689653,0,0.0,6.180055962
Lv,116,256,372,2.206896551724138,0,1.0,6.16565668
Lv,116,258,374,2.2241379310344827,0,1.0,6.133962219
Lv,116,273,389,2.353448275862069,0,0.0,5.865821548
Lv,116,274,390,2.3620689655172415,0,1.0,5.854907038
Ts,117,166,283,1.4188034188034189,0,0.0,7.047494286
Ts,117,168,285,1.435897435897436,0,0.0,7.050526804
Ts,117,170,287,1.452991452991453,0,0.0,7.052799321
Ts,117,171,288,1.4615384615384615,0,-1.0,7.053261448
Ts,117,172,289,1.4700854700854702,0,0.0,7.055390062
Ts,117,173,290,1.4786324786324787,0,-1.0,7.05456961
Ts,117,174,291,1.4871794871794872,0,0.0,7.055444423
Ts,117,175,292,1.4957264957264957,0,-1.0,7.052784675
Ts,117,176,293,1.5042735042735043,0,0.0,7.0520537
Ts,117,177,294,1.5128205128205128,0,-1.0,7.04962916
Ts,117,178,295,1.5213675213675213,0,0.0,7.049446793
Ts,117,179,296,1.5299145299145298,0,-1.0,7.045170892
Ts,117,180,297,1.5384615384615385,0,0.0,7.043309444
Ts,117,181,298,1.547008547008547,0,-1.0,7.038689248
Ts,117,182,299,1.5555555555555556,0,0.0,7.036541207
Ts,117,183,300,1.564102564102564,0,-1.0,7.030512283
Ts,117,184,301,1.5726495726495726,0,0.0,7.027029797
Ts,117,185,302,1.5811965811965811,0,-1.0,7.016241318
Ts,117,186,303,1.5897435897435896,0,0.0,7.008081257
Ts,117,187,304,1.5982905982905984,0,-1.0,6.996000138
Ts,117,188,305,1.606837606837607,0,0.0,6.986544941
Ts,117,189,306,1.6153846153846154,0,-1.0,6.975051121
Ts,117,190,307,1.623931623931624,0,0.0,6.966117554
Ts,117,191,308,1.6324786324786325,0,-1.0,6.956124653
Ts,117,192,309,1.641025641025641,0,0.0,6.94851857
Ts,117,193,310,1.6495726495726495,0,-1.0,6.944029084
Ts,117,194,311,1.6581196581196582,0,0.0,6.941942013
Ts,117,195,312,1.6666666666666667,0,-1.0,6.928023157
Ts,117,196,313,1.6752136752136753,0,0.0,6.916586553
Ts,117,197,314,1.6837606837606838,0,-1.0,6.906281621
Ts,117,198,315,1.6923076923076923,0,0.0,6.89828033
Ts,117,199,316,1.7008547008547008,0,-1.0,6.891590911
Ts,117,200,317,1.7094017094017093,0,0.0,6.887177221
Ts,117,201,318,1.7179487179487178,0,-1.0,6.87728544
Ts,117,202,319,1.7264957264957266,0,0.0,6.869910708
Ts,117,203,320,1.735042735042735,0,-1.0,6.8582497
Ts,117,204,321,1.7435897435897436,0,0.0,6.849289928
Ts,117,205,322,1.7521367521367521,0,-1.0,6.838727028
Ts,117,206,323,1.7606837606837606,0,0.0,6.830787074
Ts,117,207,324,1.7692307692307692,0,-1.0,6.81986896
Ts,117,208,325,1.7777777777777777,0,0.0,6.811562348
Ts,117,209,326,1.7863247863247864,0,-1.0,6.800384607
Ts,117,210,327,1.794871794871795,0,0.0,6.791836566
Ts,117,211,328,1.8034188034188035,0,-1.0,6.780148345
Ts,117,212,329,1.811965811965812,0,0.0,6.771078653
Ts,117,213,330,1.8205128205128205,0,-1.0,6.759250442
Ts,117,214,331,1.829059829059829,0,0.0,6.750001187
Ts,117,215,332,1.8376068376068375,0,-1.0,6.738237217
Ts,117,216,333,1.8461538461538463,0,0.0,6.729014751
Ts,117,217,334,1.8547008547008548,0,-1.0,6.717229766
Ts,117,218,335,1.8632478632478633,0,0.0,6.70795931
Ts,117,219,336,1.8717948717948718,0,-1.0,6.695508232
Ts,117,220,337,1.8803418803418803,0,0.0,6.685547549
Ts,117,221,338,1.8888888888888888,0,-1.0,6.672159888
Ts,117,222,339,1.8974358974358974,0,0.0,6.661208018
Ts,117,223,340,1.9059829059829059,0,-1.0,6.64772005
Ts,117,224,341,1.9145299145299146,0,0.0,6.636544023
Ts,117,225,342,1.9230769230769231,0,-1.0,6.623441313
Ts,117,226,343,1.9316239316239316,0,0.0,6.61248084
Ts,117,227,344,1.9401709401709402,0,-1.0,6.599582172
Ts,117,228,345,1.9487179487179487,0,0.0,6.588666319
Ts,117,229,346,1.9572649572649572,0,-1.0,6.575601462
Ts,117,230,347,1.9658119658119657,0,0.0,6.564392761
Ts,117,231,348,1.9743589743589745,0,-1.0,6.550670664
Ts,117,232,349,1.982905982905983,0,0.0,6.538705401
Ts,117,233,350,1.9914529914529915,0,-1.0,6.52399818
Ts,117,234,351,2.0,0,0.0,6.510962174
Ts,117,235,352,2.0085470085470085,0,-1.0,6.495641611
Ts,117,236,353,2.017094017094017,0,0.0,6.481906997
Ts,117,237,354,2.0256410256410255,0,-1.0,6.466415941
Ts,117,238,355,2.034188034188034,0,0.0,6.452426146
Ts,117,239,356,2.0427350427350426,0,-1.0,6.436987197
Ts,117,240,357,2.051282051282051,0,0.0,6.422965563
Ts,117,241,358,2.0598290598290596,0,-1.0,6.407734003
Ts,117,242,359,2.0683760683760686,0,0.0,6.393881499
Ts,117,243,360,2.076923076923077,0,-1.0,6.378723519
Ts,117,244,361,2.0854700854700856,0,0.0,6.365036188
Ts,117,245,362,2.094017094017094,0,-1.0,6.349546133
Ts,117,246,363,2.1025641025641026,0,0.0,6.335751267
Ts,117,247,364,2.111111111111111,0,-1.0,6.319885005
Ts,117,248,365,2.1196581196581197,0,0.0,6.305850216
Ts,117,249,366,2.128205128205128,0,-1.0,6.290033724
Ts,117,250,367,2.1367521367521367,0,0.0,6.276051431
Ts,117,251,368,2.1452991452991452,0,-1.0,6.259862571
Ts,117,252,369,2.1538461538461537,0,0.0,6.245525008
Ts,117,253,370,2.1623931623931623,0,-1.0,6.229105132
Ts,117,254,371,2.1709401709401708,0,0.0,6.214557337
Ts,117,255,372,2.1794871794871793,0,-1.0,6.198441159
Ts,117,256,373,2.1880341880341883,0,0.0,6.184218236
Ts,117,258,375,2.2051282051282053,0,0.0,6.152730248
Ts,117,273,390,2.3333333333333335,0,-1.0,5.887759759
Ts,117,274,391,2.341880341880342,0,0.0,5.877001082
Og,118,167,285,1.4152542372881356,0,0.0,7.023426639
Og,118,169,287,1.4322033898305084,0,0.0,7.02840554
Og,118,170,288,1.4406779661016949,0,1.0,7.031716066
Og,118,171,289,1.4491525423728813,0,0.0,7.03319263
Og,118,172,290,1.4576271186440677,0,1.0,7.036316841
Og,118,173,291,1.4661016949152543,0,0.0,7.0362661
Og,118,174,292,1.4745762711864407,0,1.0,7.037847695
Og,118,175,293,1.4830508474576272,0,0.0,7.03650584
Og,118,176,294,1.4915254237288136,0,1.0,7.037022214
Og,118,177,295,1.5,0,0.0,7.035341681
Og,118,178,296,1.5084745762711864,0,1.0,7.035745811
Og,118,179,297,1.5169491525423728,0,0.0,7.032023077
Og,118,180,298,1.5254237288135593,0,1.0,7.030456805
Og,118,181,299,1.5338983050847457,0,0.0,7.026455886
Og,118,182,300,1.5423728813559323,0,1.0,7.024700623
Og,118,183,301,1.5508474576271187,0,0.0,7.019512422
Og,118,184,302,1.5593220338983051,0,1.0,7.016665752
Og,118,185,303,1.5677966101694916,0,0.0,7.006772538
Og,118,186,304,1.576271186440678,0,1.0,6.999303424
Og,118,187,305,1.5847457627118644,0,0.0,6.98818699
Og,118,188,306,1.5932203389830508,0,1.0,6.979489784
Og,118,189,307,1.6016949152542372,0,0.0,6.968782463
Og,118,190,308,1.6101694915254237,0,1.0,6.960415156
Og,118,191,309,1.61864406779661,0,0.0,6.951030201
Og,118,192,310,1.6271186440677967,0,1.0,6.943812455
Og,118,193,311,1.6355932203389831,0,0.0,6.93899001
Og,118,194,312,1.6440677966101696,0,1.0,6.93647241
Og,118,195,313,1.652542372881356,0,0.0,6.922195866
Og,118,196,314,1.6610169491525424,0,1.0,6.910495471
Og,118,197,315,1.6694915254237288,0,0.0,6.900433403
Og,118,198,316,1.6779661016949152,0,1.0,6.892847883
Og,118,199,317,1.6864406779661016,0,0.0,6.886679596
Og,118,200,318,1.694915254237288,0,1.0,6.882667415
Og,118,201,319,1.7033898305084745,0,0.0,6.87416785
Og,118,202,320,1.7118644067796611,0,1.0,6.867973669
Og,118,203,321,1.7203389830508475,0,0.0,6.856466355
Og,118,204,322,1.728813559322034,0,1.0,6.847706565
Og,118,205,323,1.7372881355932204,0,0.0,6.837584824
Og,118,206,324,1.7457627118644068,0,1.0,6.830173599
Og,118,207,325,1.7542372881355932,0,0.0,6.819752889
Og,118,208,326,1.7627118644067796,0,1.0,6.81200316
Og,118,209,327,1.771186440677966,0,0.0,6.801310988
Og,118,210,328,1.7796610169491525,0,1.0,6.793281729
Og,118,211,329,1.7881355932203389,0,0.0,6.78208172
Og,118,212,330,1.7966101694915255,0,1.0,6.773518327
Og,118,213,331,1.805084745762712,0,0.0,6.762166707
Og,118,214,332,1.8135593220338984,0,1.0,6.753398792
Og,118,215,333,1.8220338983050848,0,0.0,6.742061336
Og,118,216,334,1.8305084745762712,0,1.0,6.733259096
Og,118,217,335,1.8389830508474576,0,0.0,6.721859797
Og,118,218,336,1.847457627118644,0,1.0,6.712963357
Og,118,219,337,1.8559322033898304,0,0.0,6.700929312
Og,118,220,338,1.8644067796610169,0,1.0,6.69136987
Og,118,221,339,1.8728813559322033,0,0.0,6.678403357
Og,118,222,340,1.88135593220339,0,1.0,6.667864841
Og,118,223,341,1.8898305084745763,0,0.0,6.654743733
Og,118,224,342,1.8983050847457628,0,1.0,6.643954968
Og,118,225,343,1.9067796610169492,0,0.0,6.631164539
Og,118,226,344,1.9152542372881356,0,1.0,6.620571666
Og,118,227,345,1.923728813559322,0,0.0,6.607927414
Og,118,228,346,1.9322033898305084,0,1.0,6.59734413
Og,118,229,347,1.9406779661016949,0,0.0,6.584500389
Og,118,230,348,1.9491525423728813,0,1.0,6.573595828
Og,118,231,349,1.9576271186440677,0,0.0,6.560123129
Og,118,232,350,1.9661016949152543,0,1.0,6.548485429
Og,118,233,351,1.9745762711864407,0,0.0,6.534109775
Og,118,234,352,1.9830508474576272,0,1.0,6.521479253
Og,118,235,353,1.9915254237288136,0,0.0,6.506579986
Og,118,236,354,2.0,0,1.0,6.493342277
Og,118,237,355,2.0084745762711864,0,0.0,6.478351955
Og,118,238,356,2.016949152542373,0,1.0,6.464946758
Og,118,239,357,2.0254237288135593,0,0.0,6.45015177
Og,118,240,358,2.0338983050847457,0,1.0,6.436854768
Og,118,241,359,2.042372881355932,0,0.0,6.42218995
Og,118,242,360,2.0508474576271185,0,1.0,6.408955928
Og,118,243,361,2.059322033898305,0,0.0,6.394501676
Og,118,244,362,2.0677966101694913,0,1.0,6.381578928
Og,118,245,363,2.0762711864406778,0,0.0,6.366709601
Og,118,246,364,2.0847457627118646,0,1.0,6.353485602
Og,118,247,365,2.093220338983051,0,0.0,6.337958986
Og,118,248,366,2.1016949152542375,0,1.0,6.32407377
Og,118,249,367,2.110169491525424,0,0.0,6.308584907
Og,118,250,368,2.1186440677966103,0,1.0,6.294742217
Og,118,251,369,2.1271186440677967,0,0.0,6.278851867
Og,118,252,370,2.135593220338983,0,1.0,6.264629897
Og,118,253,371,2.1440677966101696,0,0.0,6.248549892
Og,118,254,372,2.152542372881356,0,1.0,6.23416429
Og,118,255,373,2.1610169491525424,0,0.0,6.218370287
Og,118,256,374,2.169491525423729,0,1.0,6.204299898
Og,118,257,375,2.1779661016949152,0,0.0,6.187995763
Og,118,258,376,2.1864406779661016,0,1.0,6.173447686
Og,118,273,391,2.3135593220338984,0,0.0,5.912425934
Og,118,274,392,2.3220338983050848,0,1.0,5.901633237
Uue,119,170,289,1.4285714285714286,0,0.0,7.005278529
Uue,119,172,291,1.4453781512605042,0,0.0,7.01162977
Uue,119,173,292,1.453781512605042,0,-1.0,7.012339976
Uue,119,174,293,1.4621848739495797,0,0.0,7.014799273
Uue,119,175,294,1.4705882352941178,0,-1.0,7.014675724
Uue,119,176,295,1.4789915966386555,0,0.0,7.016359983
Uue,119,177,296,1.4873949579831933,0,-1.0,7.015437226
Uue,119,178,297,1.495798319327731,0,0.0,7.016390279
Uue,119,179,298,1.504201680672269,0,-1.0,7.013543735
Uue,119,180,299,1.5126050420168067,0,0.0,7.01263488
Uue,119,181,300,1.5210084033613445,0,-1.0,7.009490683
Uue,119,182,301,1.5294117647058822,0,0.0,7.008395854
Uue,119,183,302,1.5378151260504203,0,-1.0,7.003742934
Uue,119,184,303,1.546218487394958,0,0.0,7.001247033
Uue,119,185,304,1.5546218487394958,0,-1.0,6.991903309
Uue,119,186,305,1.5630252100840336,0,0.0,6.984794102
Uue,119,187,306,1.5714285714285714,0,-1.0,6.974161752
Uue,119,188,307,1.5798319327731092,0,0.0,6.96575687
Uue,119,189,308,1.588235294117647,0,-1.0,6.955499523
Uue,119,190,309,1.596638655462185,0,0.0,6.947399104
Uue,119,191,310,1.6050420168067228,0,-1.0,6.938696552
Uue,119,192,311,1.6134453781512605,0,0.0,6.932105219
Uue,119,193,312,1.6218487394957983,0,-1.0,6.925776494
Uue,119,194,313,1.6302521008403361,0,0.0,6.921695345
Uue,119,195,314,1.638655462184874,0,-1.0,6.910206529
Uue,119,196,315,1.6470588235294117,0,0.0,6.901109651
Uue,119,197,316,1.6554621848739495,0,-1.0,6.893461212
Uue,119,198,317,1.6638655462184875,0,0.0,6.88800953
Uue,119,199,318,1.6722689075630253,0,-1.0,6.88085294
Uue,119,200,319,1.680672268907563,0,0.0,6.875605119
Uue,119,201,320,1.6890756302521008,0,-1.0,6.8650288
Uue,119,202,321,1.6974789915966386,0,0.0,6.856699903
Uue,119,203,322,1.7058823529411764,0,-1.0,6.848501394
Uue,119,204,323,1.7142857142857142,0,0.0,6.842754585
Uue,119,205,324,1.7226890756302522,0,-1.0,6.833138948
Uue,119,206,325,1.73109243697479,0,0.0,6.825735049
Uue,119,207,326,1.7394957983193278,0,-1.0,6.815758092
Uue,119,208,327,1.7478991596638656,0,0.0,6.807983807
Uue,119,209,328,1.7563025210084033,0,-1.0,6.797642433
Uue,119,210,329,1.7647058823529411,0,0.0,6.789726693
Uue,119,211,330,1.773109243697479,0,-1.0,6.779012327
Uue,119,212,331,1.781512605042017,0,0.0,6.770912341
Uue,119,213,332,1.7899159663865547,0,-1.0,6.760040696
Uue,119,214,333,1.7983193277310925,0,0.0,6.751722453
Uue,119,215,334,1.8067226890756303,0,-1.0,6.740846257
Uue,119,216,335,1.815126050420168,0,0.0,6.732470403
Uue,119,217,336,1.8235294117647058,0,-1.0,6.721551518
Uue,119,218,337,1.8319327731092436,0,0.0,6.713099107
Uue,119,219,338,1.8403361344537814,0,-1.0,6.701568769
Uue,119,220,339,1.8487394957983194,0,0.0,6.692475071
Uue,119,221,340,1.8571428571428572,0,-1.0,6.680010676
Uue,119,222,341,1.865546218487395,0,0.0,6.669935525
Uue,119,223,342,1.8739495798319328,0,-1.0,6.657222257
Uue,119,224,343,1.8823529411764706,0,0.0,6.646819539
Uue,119,225,344,1.8907563025210083,0,-1.0,6.634381709
Uue,119,226,345,1.8991596638655461,0,0.0,6.624151452
Uue,119,227,346,1.9075630252100841,0,-1.0,6.611815419
Uue,119,228,347,1.915966386554622,0,0.0,6.60158232
Uue,119,229,348,1.9243697478991597,0,-1.0,6.58900392
Uue,119,230,349,1.9327731092436975,0,0.0,6.57843694
Uue,119,231,350,1.9411764705882353,0,-1.0,6.565212069
Uue,119,232,351,1.949579831932773,0,0.0,6.553926214
Uue,119,233,352,1.9579831932773109,0,-1.0,6.539791722
Uue,119,234,353,1.9663865546218486,0,0.0,6.527532946
Uue,119,235,354,1.9747899159663866,0,-1.0,6.512866669
Uue,119,236,355,1.9831932773109244,0,0.0,6.499913893
Uue,119,237,356,1.9915966386554622,0,-1.0,6.485922671
Uue,119,238,357,2.0,0,0.0,6.473489655
Uue,119,239,358,2.008403361344538,0,-1.0,6.459409531
Uue,119,240,359,2.0168067226890756,0,0.0,6.446840811
Uue,119,241,360,2.0252100840336134,0,-1.0,6.432803175
Uue,119,242,361,2.033613445378151,0,0.0,6.420242089
Uue,119,243,362,2.042016806722689,0,-1.0,6.406266577
Uue,119,244,363,2.0504201680672267,0,0.0,6.393817207
Uue,119,245,364,2.0588235294117645,0,-1.0,6.37930589
Uue,119,246,365,2.0672268907563027,0,0.0,6.366371797
Uue,119,247,366,2.0756302521008405,0,-1.0,6.351224096
Uue,119,248,367,2.0840336134453783,0,0.0,6.337626011
Uue,119,249,368,2.092436974789916,0,-1.0,6.322520796
Uue,119,250,369,2.100840336134454,0,0.0,6.308935444
Uue,119,251,370,2.1092436974789917,0,-1.0,6.293457673
Uue,119,252,371,2.1176470588235294,0,0.0,6.279502394
Uue,119,253,372,2.1260504201680672,0,-1.0,6.263871132
Uue,119,254,373,2.134453781512605,0,0.0,6.249785893
Uue,119,255,374,2.142857142857143,0,-1.0,6.234356567
Uue,119,256,375,2.1512605042016806,0,0.0,6.220509445
Uue,119,257,376,2.1596638655462184,0,-1.0,6.20441075
Uue,119,258,377,2.168067226890756,0,0.0,6.189930236
Uue,119,273,392,2.2941176470588234,0,-1.0,5.932762781
Uue,119,274,393,2.302521008403361,0,0.0,5.921863692
Ubn,120,171,291,1.425,0,0.0,6.985108687
Ubn,120,172,292,1.4333333333333333,0,1.0,6.989927596
Ubn,120,173,293,1.4416666666666667,0,0.0,6.99125601
Ubn,120,174,294,1.45,0,1.0,6.994450442
Ubn,120,175,295,1.4583333333333333,0,0.0,6.995499783
Ubn,120,176,296,1.4666666666666666,0,1.0,6.998307145
Ubn,120,177,297,1.475,0,0.0,6.998052145
Ubn,120,178,298,1.4833333333333334,0,1.0,6.999466107
Ubn,120,179,299,1.4916666666666667,0,0.0,6.99735193
Ubn,120,180,300,1.5,0,1.0,6.996959097
Ubn,120,181,301,1.5083333333333333,0,0.0,6.994578711
Ubn,120,182,302,1.5166666666666666,0,1.0,6.994053318
Ubn,120,183,303,1.525,0,0.0,6.990314904
Ubn,120,184,304,1.5333333333333334,0,1.0,6.988547717
Ubn,120,185,305,1.5416666666666667,0,0.0,6.980078348
Ubn,120,186,306,1.55,0,1.0,6.97365302
Ubn,120,187,307,1.5583333333333333,0,0.0,6.96395415
Ubn,120,188,308,1.5666666666666667,0,1.0,6.956289321
Ubn,120,189,309,1.575,0,0.0,6.946686715
Ubn,120,190,310,1.5833333333333333,0,1.0,6.939057816
Ubn,120,191,311,1.5916666666666666,0,0.0,6.930743392
Ubn,120,192,312,1.6,0,1.0,6.924486433
Ubn,120,193,313,1.6083333333333334,0,0.0,6.916454179
Ubn,120,194,314,1.6166666666666667,0,1.0,6.910613854
Ubn,120,195,315,1.625,0,0.0,6.902091476
Ubn,120,196,316,1.6333333333333333,0,1.0,6.895776867
Ubn,120,197,317,1.6416666666666666,0,0.0,6.890443325
Ubn,120,198,318,1.65,0,1.0,6.887029123
Ubn,120,199,319,1.6583333333333334,0,0.0,6.878807649
Ubn,120,200,320,1.6666666666666667,0,1.0,6.872249625
Ubn,120,201,321,1.675,0,0.0,6.859449645
Ubn,120,202,322,1.6833333333333333,0,1.0,6.848840398
Ubn,120,203,323,1.6916666666666667,0,0.0,6.843986957
Ubn,120,204,324,1.7,0,1.0,6.841290997
Ubn,120,205,325,1.7083333333333333,0,0.0,6.832156754
Ubn,120,206,326,1.7166666666666666,0,1.0,6.824738681
Ubn,120,207,327,1.725,0,0.0,6.815157232
Ubn,120,208,328,1.7333333333333334,0,1.0,6.807313302
Ubn,120,209,329,1.7416666666666667,0,0.0,6.797175875
Ubn,120,210,330,1.75,0,1.0,6.789229127
Ubn,120,211,331,1.7583333333333333,0,0.0,6.779008912
Ubn,120,212,332,1.7666666666666666,0,1.0,6.771380925
Ubn,120,213,333,1.775,0,0.0,6.760987459
Ubn,120,214,334,1.7833333333333334,0,1.0,6.753117287
Ubn,120,215,335,1.7916666666666667,0,0.0,6.742646857
Ubn,120,216,336,1.8,0,1.0,6.734642429
Ubn,120,217,337,1.8083333333333333,0,0.0,6.724104068
Ubn,120,218,338,1.8166666666666667,0,1.0,6.715996601
Ubn,120,219,339,1.825,0,0.0,6.704908903
Ubn,120,220,340,1.8333333333333333,0,1.0,6.696220459
Ubn,120,221,341,1.8416666666666666,0,0.0,6.684220686
Ubn,120,222,342,1.85,0,1.0,6.674571839
Ubn,120,223,343,1.8583333333333334,0,0.0,6.662284306
Ubn,120,224,344,1.8666666666666667,0,1.0,6.652285555
Ubn,120,225,345,1.875,0,0.0,6.640176052
Ubn,120,226,346,1.8833333333333333,0,1.0,6.630284223
Ubn,120,227,347,1.8916666666666666,0,0.0,6.618178542
Ubn,120,228,348,1.9,0,1.0,6.608217971
Ubn,120,229,349,1.9083333333333334,0,0.0,6.595815014
Ubn,120,230,350,1.9166666666666667,0,1.0,6.585495829
Ubn,120,231,351,1.925,0,0.0,6.572459689
Ubn,120,232,352,1.9333333333333333,0,1.0,6.56146633
Ubn,120,233,353,1.9416666666666667,0,0.0,6.547553348
Ubn,120,234,354,1.95,0,1.0,6.535646037
Ubn,120,235,355,1.9583333333333333,0,0.0,6.521357087
Ubn,120,236,356,1.9666666666666666,0,1.0,6.508832478
Ubn,120,237,357,1.975,0,0.0,6.495829381
Ubn,120,238,358,1.9833333333333334,0,1.0,6.484357782
Ubn,120,239,359,1.9916666666666667,0,0.0,6.47099115
Ubn,120,240,360,2.0,0,1.0,6.459149269
Ubn,120,241,361,2.0083333333333333,0,0.0,6.445686139
Ubn,120,242,362,2.0166666666666666,0,1.0,6.433745345
Ubn,120,243,363,2.025,0,0.0,6.420188658
Ubn,120,244,364,2.033333333333333,0,1.0,6.408153102
Ubn,120,245,365,2.0416666666666665,0,0.0,6.393942447
Ubn,120,246,366,2.05,0,1.0,6.381241593
Ubn,120,247,367,2.058333333333333,0,0.0,6.366394932
Ubn,120,248,368,2.066666666666667,0,1.0,6.353007027
Ubn,120,249,369,2.075,0,0.0,6.338253417
Ubn,120,250,370,2.0833333333333335,0,1.0,6.324894216
Ubn,120,251,371,2.091666666666667,0,0.0,6.309770199
Ubn,120,252,372,2.1,0,1.0,6.296023887
Ubn,120,253,373,2.1083333333333334,0,0.0,6.280814064
Ubn,120,254,374,2.1166666666666667,0,1.0,6.267002826
Ubn,120,255,375,2.125,0,0.0,6.251913688
Ubn,120,256,376,2.1333333333333333,0,1.0,6.238266229
Ubn,120,257,377,2.1416666666666666,0,0.0,6.222582976
Ubn,120,258,378,2.15,0,1.0,6.208379635
Ubn,120,273,393,2.275,0,0.0,5.95587345
Ubn,120,274,394,2.283333333333333,0,1.0,5.944602898
